videoId,긍정,부정,중립,댓글수,긍정비율,중립비율,부정비율
-037NLTIrb8,42,31,7,80,0.525,0.525,0.3875
-0_BEoAcyOo,40,46,7,93,0.43010752688172044,0.43010752688172044,0.4946236559139785
-15arAePyN4,3,3,0,6,0.5,0.5,0.5
-2AWXdUwWtU,57,33,2,92,0.6195652173913043,0.6195652173913043,0.358695652173913
-2R4PxXvfZ4,14,3,1,18,0.7777777777777778,0.7777777777777778,0.16666666666666666
-3kDqAl7ND0,57,188,18,263,0.21673003802281368,0.21673003802281368,0.714828897338403
-41JQklIDtc,5,10,3,18,0.2777777777777778,0.2777777777777778,0.5555555555555556
-4Z6zwkp9hE,8,5,1,14,0.5714285714285714,0.5714285714285714,0.35714285714285715
-4dhAZ78TRE,48,126,20,194,0.24742268041237114,0.24742268041237114,0.6494845360824743
-4fGaKYgTTs,9,20,2,31,0.2903225806451613,0.2903225806451613,0.6451612903225806
-4wGWaBGyMM,19,14,2,35,0.5428571428571428,0.5428571428571428,0.4
-5arJlYVA2E,11,17,1,29,0.3793103448275862,0.3793103448275862,0.5862068965517241
-6KZi-v9SsA,10,11,1,22,0.45454545454545453,0.45454545454545453,0.5
-6r5Alj_a4g,18,49,8,75,0.24,0.24,0.6533333333333333
-7I-GjnxGA0,48,105,6,159,0.3018867924528302,0.3018867924528302,0.660377358490566
-7X-3kwCsV8,12,6,1,19,0.631578947368421,0.631578947368421,0.3157894736842105
-7qsYLio8KI,6,13,1,20,0.3,0.3,0.65
-9H6kbE8hrk,3,5,0,8,0.375,0.375,0.625
-B7ZZ4hgAzs,16,20,3,39,0.41025641025641024,0.41025641025641024,0.5128205128205128
-Bidqb1VXVU,12,21,2,35,0.34285714285714286,0.34285714285714286,0.6
-CTzXrom9vs,34,30,5,69,0.4927536231884058,0.4927536231884058,0.43478260869565216
-CvbC1ZF41k,10,9,3,22,0.45454545454545453,0.45454545454545453,0.4090909090909091
-E-z1xao9d0,7,14,1,22,0.3181818181818182,0.3181818181818182,0.6363636363636364
-E5f5hdCL5I,8,25,1,34,0.23529411764705882,0.23529411764705882,0.7352941176470589
-GGMaOkIIYY,4,10,0,14,0.2857142857142857,0.2857142857142857,0.7142857142857143
-Gmz-Z5LROk,23,22,2,47,0.48936170212765956,0.48936170212765956,0.46808510638297873
-I97WcSxKSA,5,5,0,10,0.5,0.5,0.5
-IDalXFYTuo,10,5,1,16,0.625,0.625,0.3125
-IhaoL49Hoc,3,10,1,14,0.21428571428571427,0.21428571428571427,0.7142857142857143
-IruaMqbe1w,3,13,1,17,0.17647058823529413,0.17647058823529413,0.7647058823529411
-JdiNg4yPS0,28,44,0,72,0.3888888888888889,0.3888888888888889,0.6111111111111112
-Jyea3YKYvU,2,16,2,20,0.1,0.1,0.8
-M73Y2dwq08,4,32,5,41,0.0975609756097561,0.0975609756097561,0.7804878048780488
-NtUA0s4jeg,13,13,1,27,0.48148148148148145,0.48148148148148145,0.48148148148148145
-PD9d1Nze20,15,12,1,28,0.5357142857142857,0.5357142857142857,0.42857142857142855
-PZTj5qHtgc,35,129,11,175,0.2,0.2,0.7371428571428571
-Q0YqA2UDOs,5,15,3,23,0.21739130434782608,0.21739130434782608,0.6521739130434783
-S-r70QeYHg,88,137,7,232,0.3793103448275862,0.3793103448275862,0.5905172413793104
-SBUCwDLaVo,46,17,4,67,0.6865671641791045,0.6865671641791045,0.2537313432835821
-SEHrNJq1UQ,192,151,18,361,0.5318559556786704,0.5318559556786704,0.4182825484764543
-SsDBY9jb4Y,70,138,18,226,0.30973451327433627,0.30973451327433627,0.6106194690265486
-T6PANwYnDc,5,1,1,7,0.7142857142857143,0.7142857142857143,0.14285714285714285
-T72x1CbhAc,3,5,1,9,0.3333333333333333,0.3333333333333333,0.5555555555555556
-UT-IuYjBic,7,7,1,15,0.4666666666666667,0.4666666666666667,0.4666666666666667
-UyDo-7MF10,15,12,1,28,0.5357142857142857,0.5357142857142857,0.42857142857142855
-WXeNIpUkRM,14,55,5,74,0.1891891891891892,0.1891891891891892,0.7432432432432432
-Wmmh4CUgzQ,23,18,2,43,0.5348837209302325,0.5348837209302325,0.4186046511627907
-XZdWrLbgt4,6,21,2,29,0.20689655172413793,0.20689655172413793,0.7241379310344828
-Xkpajfys68,12,52,2,66,0.18181818181818182,0.18181818181818182,0.7878787878787878
-Z-yIBf5ttA,44,86,11,141,0.3120567375886525,0.3120567375886525,0.6099290780141844
-_FipOlfNgE,41,182,14,237,0.1729957805907173,0.1729957805907173,0.7679324894514767
-_rSpS95ZO0,0,13,0,13,0,0,1
-a13rKvEAJI,88,154,37,279,0.3154121863799283,0.3154121863799283,0.5519713261648745
-b_A86wO4Wo,16,7,4,27,0.5925925925925926,0.5925925925925926,0.25925925925925924
-bbyejJSwTk,37,62,1,100,0.37,0.37,0.62
-cWv4a9DSq4,10,19,0,29,0.3448275862068966,0.3448275862068966,0.6551724137931034
-f3UWWlxs2Q,873,157,59,1089,0.8016528925619835,0.8016528925619835,0.14416896235078053
-hpai5mcny8,8,4,2,14,0.5714285714285714,0.5714285714285714,0.2857142857142857
-img2_AdicM,6,6,2,14,0.42857142857142855,0.42857142857142855,0.42857142857142855
-io9xxqE9eY,0,1,2,3,0,0,0.3333333333333333
-lYtujRLj0w,12,10,1,23,0.5217391304347826,0.5217391304347826,0.43478260869565216
-mbuE3a91q8,4,19,3,26,0.15384615384615385,0.15384615384615385,0.7307692307692307
-p1Logq62Pc,19,38,7,64,0.296875,0.296875,0.59375
-qL7pP398mE,465,350,69,884,0.5260180995475113,0.5260180995475113,0.39592760180995473
-qNUhgsYGf0,90,67,21,178,0.5056179775280899,0.5056179775280899,0.37640449438202245
-tWbm5WBGoA,30,106,27,163,0.18404907975460122,0.18404907975460122,0.6503067484662577
-vGPI2AAqHY,14,6,1,21,0.6666666666666666,0.6666666666666666,0.2857142857142857
-vKlsCbG5mE,7,5,1,13,0.5384615384615384,0.5384615384615384,0.38461538461538464
-vUdz020HOs,18,18,4,40,0.45,0.45,0.45
-vaqX58BmIc,10,10,1,21,0.47619047619047616,0.47619047619047616,0.47619047619047616
-wX-WN8lYo8,10,13,1,24,0.4166666666666667,0.4166666666666667,0.5416666666666666
-yjpJI3-gLw,10,28,2,40,0.25,0.25,0.7
-ywXxdoRT-s,98,90,13,201,0.48756218905472637,0.48756218905472637,0.44776119402985076
-yxziUIPZkI,12,10,2,24,0.5,0.5,0.4166666666666667
-zHaWR61rBc,6,11,0,17,0.35294117647058826,0.35294117647058826,0.6470588235294118
0-a0C2e9gYs,6,10,2,18,0.3333333333333333,0.3333333333333333,0.5555555555555556
0-sjs5uZlt4,6,19,2,27,0.2222222222222222,0.2222222222222222,0.7037037037037037
003QbcTnnTc,13,16,5,34,0.38235294117647056,0.38235294117647056,0.47058823529411764
00uJ1dor2L4,2,13,2,17,0.11764705882352941,0.11764705882352941,0.7647058823529411
01CYSjRrP_Y,15,35,3,53,0.2830188679245283,0.2830188679245283,0.660377358490566
01m3P4-uJL4,22,12,0,34,0.6470588235294118,0.6470588235294118,0.35294117647058826
03IQhHGmZXo,153,93,13,259,0.5907335907335908,0.5907335907335908,0.3590733590733591
03c_G5LDNGc,5,8,0,13,0.38461538461538464,0.38461538461538464,0.6153846153846154
04nyQB8jCN0,43,183,4,230,0.18695652173913044,0.18695652173913044,0.7956521739130434
06vM6aqf474,11,16,1,28,0.39285714285714285,0.39285714285714285,0.5714285714285714
08WgpOne6-A,31,70,5,106,0.29245283018867924,0.29245283018867924,0.660377358490566
0BwtT8JPVu4,5,24,4,33,0.15151515151515152,0.15151515151515152,0.7272727272727273
0DaWbspl4ws,5,9,1,15,0.3333333333333333,0.3333333333333333,0.6
0EHCZSNpiMk,2,4,0,6,0.3333333333333333,0.3333333333333333,0.6666666666666666
0ES5vGXkNRc,6,8,0,14,0.42857142857142855,0.42857142857142855,0.5714285714285714
0EmAtPxtGlc,3,2,0,5,0.6,0.6,0.4
0GH4e2mWb2U,44,45,5,94,0.46808510638297873,0.46808510638297873,0.4787234042553192
0IVo0DaykZs,2,6,0,8,0.25,0.25,0.75
0IbIknsVwUs,4,3,0,7,0.5714285714285714,0.5714285714285714,0.42857142857142855
0IoWQ1QTyjM,6,20,6,32,0.1875,0.1875,0.625
0NHpMOayBAg,5,2,0,7,0.7142857142857143,0.7142857142857143,0.2857142857142857
0O6FnZ0BApM,13,17,3,33,0.3939393939393939,0.3939393939393939,0.5151515151515151
0OvcjFGrXFU,23,12,7,42,0.5476190476190477,0.5476190476190477,0.2857142857142857
0PA-JKkZ3_g,9,15,0,24,0.375,0.375,0.625
0PRxIlS0nOM,10,15,3,28,0.35714285714285715,0.35714285714285715,0.5357142857142857
0Pl2az32vm8,3,5,0,8,0.375,0.375,0.625
0Q1ZvD71aOk,13,9,0,22,0.5909090909090909,0.5909090909090909,0.4090909090909091
0Q3GFzxde4A,13,16,1,30,0.43333333333333335,0.43333333333333335,0.5333333333333333
0QoWVsmUFk0,12,27,6,45,0.26666666666666666,0.26666666666666666,0.6
0RnOLUtiadI,10,34,7,51,0.19607843137254902,0.19607843137254902,0.6666666666666666
0SSqWCLIpCg,5,48,4,57,0.08771929824561403,0.08771929824561403,0.8421052631578947
0T8jsbFd8v0,11,27,2,40,0.275,0.275,0.675
0TEWPRW9NFg,69,263,34,366,0.1885245901639344,0.1885245901639344,0.7185792349726776
0Tb4IoGiR9Y,5,8,1,14,0.35714285714285715,0.35714285714285715,0.5714285714285714
0W7jIMptdRI,1,1,0,2,0.5,0.5,0.5
0WfbD_fBMWU,9,8,2,19,0.47368421052631576,0.47368421052631576,0.42105263157894735
0XINCexzDT8,6,23,4,33,0.18181818181818182,0.18181818181818182,0.696969696969697
0XNtYuJEUTI,3,12,0,15,0.2,0.2,0.8
0XrbhZXlE7E,10,24,4,38,0.2631578947368421,0.2631578947368421,0.631578947368421
0ZR10lQ6XYM,19,28,2,49,0.3877551020408163,0.3877551020408163,0.5714285714285714
0_RF0QuN7Wg,31,12,2,45,0.6888888888888889,0.6888888888888889,0.26666666666666666
0aSbNLhUWxw,23,18,1,42,0.5476190476190477,0.5476190476190477,0.42857142857142855
0bCnWWqEpSY,13,28,5,46,0.2826086956521739,0.2826086956521739,0.6086956521739131
0bZB6PMIjGs,43,27,4,74,0.581081081081081,0.581081081081081,0.36486486486486486
0bqtpFsaI9Y,10,20,2,32,0.3125,0.3125,0.625
0cD-1Xjak3s,14,32,3,49,0.2857142857142857,0.2857142857142857,0.6530612244897959
0dWfpqBVlmc,31,64,6,101,0.3069306930693069,0.3069306930693069,0.6336633663366337
0fBRkuseD0k,10,4,1,15,0.6666666666666666,0.6666666666666666,0.26666666666666666
0fwihfHNCBI,6,4,2,12,0.5,0.5,0.3333333333333333
0gISYwDv6Rc,22,86,7,115,0.19130434782608696,0.19130434782608696,0.7478260869565218
0gMEUV9Mgho,30,132,16,178,0.16853932584269662,0.16853932584269662,0.7415730337078652
0gUEZZ7kjew,7,9,0,16,0.4375,0.4375,0.5625
0hXoBKOsMOM,13,17,2,32,0.40625,0.40625,0.53125
0i1e9LMaxXM,16,8,2,26,0.6153846153846154,0.6153846153846154,0.3076923076923077
0juTFR6Mv6o,7,6,1,14,0.5,0.5,0.42857142857142855
0kDNGSRoi_I,6,4,1,11,0.5454545454545454,0.5454545454545454,0.36363636363636365
0lGnTFNsbPQ,16,36,2,54,0.2962962962962963,0.2962962962962963,0.6666666666666666
0lhePKX5GB8,11,31,0,42,0.2619047619047619,0.2619047619047619,0.7380952380952381
0m5Nswj4aHo,6,26,2,34,0.17647058823529413,0.17647058823529413,0.7647058823529411
0myRyDMg1LI,6,8,0,14,0.42857142857142855,0.42857142857142855,0.5714285714285714
0n4navB31Vg,4,11,1,16,0.25,0.25,0.6875
0nDukHFEpRU,285,120,10,415,0.6867469879518072,0.6867469879518072,0.2891566265060241
0nOS0ayFKzk,4,1,0,5,0.8,0.8,0.2
0qVLeCtD0Cg,25,20,0,45,0.5555555555555556,0.5555555555555556,0.4444444444444444
0sNpn7mLOsQ,31,49,11,91,0.34065934065934067,0.34065934065934067,0.5384615384615384
0slQaxLwd4Y,10,21,4,35,0.2857142857142857,0.2857142857142857,0.6
0uB2p96s0io,4,13,1,18,0.2222222222222222,0.2222222222222222,0.7222222222222222
0urWSyp4GtI,7,9,3,19,0.3684210526315789,0.3684210526315789,0.47368421052631576
0veVL_QG9ls,34,17,4,55,0.6181818181818182,0.6181818181818182,0.3090909090909091
0x7cww88sT0,3,5,3,11,0.2727272727272727,0.2727272727272727,0.45454545454545453
0z1xPJVm3l8,18,28,4,50,0.36,0.36,0.56
0zuVvfmD654,7,16,4,27,0.25925925925925924,0.25925925925925924,0.5925925925925926
1-5wJUiP9AU,5,4,0,9,0.5555555555555556,0.5555555555555556,0.4444444444444444
12ckeQHRY7M,330,65,10,405,0.8148148148148148,0.8148148148148148,0.16049382716049382
12e9nHLTyLA,4,8,0,12,0.3333333333333333,0.3333333333333333,0.6666666666666666
12gLfd0ekFA,49,23,1,73,0.6712328767123288,0.6712328767123288,0.3150684931506849
13S8C6YG6ro,7,12,1,20,0.35,0.35,0.6
14aWsmgPe04,4,4,1,9,0.4444444444444444,0.4444444444444444,0.4444444444444444
14ihIgAtUNw,103,140,22,265,0.3886792452830189,0.3886792452830189,0.5283018867924528
14shOnmnKVI,5,34,5,44,0.11363636363636363,0.11363636363636363,0.7727272727272727
16HVTSJNbn8,11,25,2,38,0.2894736842105263,0.2894736842105263,0.6578947368421053
16eH3JKzqlA,15,53,4,72,0.20833333333333334,0.20833333333333334,0.7361111111111112
16hjezdqXI0,24,75,6,105,0.22857142857142856,0.22857142857142856,0.7142857142857143
16nWdpNAJZg,16,104,11,131,0.12213740458015267,0.12213740458015267,0.7938931297709924
171-dRnehv0,36,47,4,87,0.41379310344827586,0.41379310344827586,0.5402298850574713
174sxQWTgH0,6,18,1,25,0.24,0.24,0.72
19bFcjn7qis,2,5,1,8,0.25,0.25,0.625
1AaFpFrpaVY,63,38,8,109,0.5779816513761468,0.5779816513761468,0.3486238532110092
1DiNSl9pOKA,66,67,9,142,0.4647887323943662,0.4647887323943662,0.47183098591549294
1FDQurUiD9A,8,26,3,37,0.21621621621621623,0.21621621621621623,0.7027027027027027
1GI7HUdoQ90,3,5,0,8,0.375,0.375,0.625
1GiqOFHRnUQ,0,7,0,7,0,0,1
1He5ZWO083A,2,5,4,11,0.18181818181818182,0.18181818181818182,0.45454545454545453
1I3wb37n46o,14,49,3,66,0.21212121212121213,0.21212121212121213,0.7424242424242424
1JHK2_MZN_k,14,43,4,61,0.22950819672131148,0.22950819672131148,0.7049180327868853
1JKPl0ad6W4,12,47,6,65,0.18461538461538463,0.18461538461538463,0.7230769230769231
1JOPuxBOEgY,131,205,29,365,0.3589041095890411,0.3589041095890411,0.5616438356164384
1K17dljqv_Y,6,49,2,57,0.10526315789473684,0.10526315789473684,0.8596491228070176
1Km8OQZnC6g,118,80,16,214,0.5514018691588785,0.5514018691588785,0.37383177570093457
1LMya1J_HvI,2,2,0,4,0.5,0.5,0.5
1LS4xUNDF8E,5,8,1,14,0.35714285714285715,0.35714285714285715,0.5714285714285714
1LgEfjemSqg,9,13,1,23,0.391304347826087,0.391304347826087,0.5652173913043478
1LwWeiVbA8w,4,7,4,15,0.26666666666666666,0.26666666666666666,0.4666666666666667
1M9wBkuZ16U,11,10,1,22,0.5,0.5,0.45454545454545453
1N6yqHk4lm0,3,3,0,6,0.5,0.5,0.5
1NAV7a9Ras0,55,51,12,118,0.4661016949152542,0.4661016949152542,0.4322033898305085
1OJDPESdVZg,5,16,1,22,0.22727272727272727,0.22727272727272727,0.7272727272727273
1QcDGrToT8k,19,27,4,50,0.38,0.38,0.54
1R-48jwZ9oQ,84,44,8,136,0.6176470588235294,0.6176470588235294,0.3235294117647059
1SkQek5xieQ,11,33,3,47,0.23404255319148937,0.23404255319148937,0.7021276595744681
1UFBw4T1fNo,5,4,0,9,0.5555555555555556,0.5555555555555556,0.4444444444444444
1VPVxpOxUM0,6,2,2,10,0.6,0.6,0.2
1VY2gOkVEe4,7,15,2,24,0.2916666666666667,0.2916666666666667,0.625
1XiPi56oMMk,10,74,4,88,0.11363636363636363,0.11363636363636363,0.8409090909090909
1ZLljmM9GOQ,15,31,4,50,0.3,0.3,0.62
1ZyeFwwpcug,16,34,5,55,0.2909090909090909,0.2909090909090909,0.6181818181818182
1_A5zmG4fIA,7,5,0,12,0.5833333333333334,0.5833333333333334,0.4166666666666667
1_MeQBaXTTU,15,17,1,33,0.45454545454545453,0.45454545454545453,0.5151515151515151
1_Tar9yvALU,9,17,3,29,0.3103448275862069,0.3103448275862069,0.5862068965517241
1_r1AEm0S0U,33,59,8,100,0.33,0.33,0.59
1acE-jUthmQ,21,21,7,49,0.42857142857142855,0.42857142857142855,0.42857142857142855
1aekk5ovlYo,1,2,0,3,0.3333333333333333,0.3333333333333333,0.6666666666666666
1cWOd6gnjGQ,16,22,1,39,0.41025641025641024,0.41025641025641024,0.5641025641025641
1cvcNtG8Br0,15,28,1,44,0.3409090909090909,0.3409090909090909,0.6363636363636364
1g8UjBRpdXc,2,12,1,15,0.13333333333333333,0.13333333333333333,0.8
1gdGGauiHMQ,7,23,3,33,0.21212121212121213,0.21212121212121213,0.696969696969697
1ih4eLXIiWg,2,1,0,3,0.6666666666666666,0.6666666666666666,0.3333333333333333
1j3dH1j-B_M,8,14,1,23,0.34782608695652173,0.34782608695652173,0.6086956521739131
1jIinUoFR0Q,293,182,58,533,0.549718574108818,0.549718574108818,0.34146341463414637
1jal5PasxBc,6,19,1,26,0.23076923076923078,0.23076923076923078,0.7307692307692307
1kQwaxcHtvc,105,73,16,194,0.5412371134020618,0.5412371134020618,0.37628865979381443
1oEUtL41oDk,5,12,1,18,0.2777777777777778,0.2777777777777778,0.6666666666666666
1otneFRlPUA,4,10,0,14,0.2857142857142857,0.2857142857142857,0.7142857142857143
1pF4miBMHss,13,28,2,43,0.3023255813953488,0.3023255813953488,0.6511627906976745
1pUgS9s8mwE,10,15,0,25,0.4,0.4,0.6
1ptCuEd2YH0,2,3,0,5,0.4,0.4,0.6
1q6mfmM54i0,22,16,0,38,0.5789473684210527,0.5789473684210527,0.42105263157894735
1q7ZlFP2nXo,7,3,1,11,0.6363636363636364,0.6363636363636364,0.2727272727272727
1ql9fzu48C4,5,7,1,13,0.38461538461538464,0.38461538461538464,0.5384615384615384
1sps6tRT5CQ,16,96,17,129,0.12403100775193798,0.12403100775193798,0.7441860465116279
1vEWqq3BDQw,8,4,1,13,0.6153846153846154,0.6153846153846154,0.3076923076923077
1vZwgJmkNbE,3,24,1,28,0.10714285714285714,0.10714285714285714,0.8571428571428571
1vsCd5gY0D8,6,16,3,25,0.24,0.24,0.64
1wNF8w9ycYw,190,745,142,1077,0.1764159702878366,0.1764159702878366,0.691736304549675
1xZpiVB1Dcs,113,127,12,252,0.44841269841269843,0.44841269841269843,0.503968253968254
1z2o-e_RtHo,15,16,0,31,0.4838709677419355,0.4838709677419355,0.5161290322580645
1z4WtGppZMc,15,5,0,20,0.75,0.75,0.25
1z5VXOrNsmw,29,45,6,80,0.3625,0.3625,0.5625
2-TWg4_CUMI,36,62,8,106,0.33962264150943394,0.33962264150943394,0.5849056603773585
20TcP31zF5k,23,63,6,92,0.25,0.25,0.6847826086956522
21PW_l5-jhk,14,23,4,41,0.34146341463414637,0.34146341463414637,0.5609756097560976
21Z-ST7VS4M,6,26,3,35,0.17142857142857143,0.17142857142857143,0.7428571428571429
23Qu5ASLXfc,12,12,1,25,0.48,0.48,0.48
24oWbA9mZNE,22,23,4,49,0.4489795918367347,0.4489795918367347,0.46938775510204084
26BOYVNl-4Q,18,49,6,73,0.2465753424657534,0.2465753424657534,0.6712328767123288
26eUbAPgj3U,6,10,3,19,0.3157894736842105,0.3157894736842105,0.5263157894736842
26pG53QuzfY,20,24,0,44,0.45454545454545453,0.45454545454545453,0.5454545454545454
27U0-Loa6LA,21,44,3,68,0.3088235294117647,0.3088235294117647,0.6470588235294118
27n1Vttt9fY,57,36,3,96,0.59375,0.59375,0.375
29GmuvTafXg,11,3,2,16,0.6875,0.6875,0.1875
29VKYSWDaV8,62,69,7,138,0.4492753623188406,0.4492753623188406,0.5
2AIPwkS9y4Y,6,17,0,23,0.2608695652173913,0.2608695652173913,0.7391304347826086
2AcS5YrPsvs,11,99,16,126,0.0873015873015873,0.0873015873015873,0.7857142857142857
2B42Fiy4oxg,7,30,5,42,0.16666666666666666,0.16666666666666666,0.7142857142857143
2CP_18m8p9Q,33,27,4,64,0.515625,0.515625,0.421875
2DD8ZvVZiTQ,11,40,3,54,0.2037037037037037,0.2037037037037037,0.7407407407407407
2DqOI08qf1E,10,19,2,31,0.3225806451612903,0.3225806451612903,0.6129032258064516
2EMJqQU2Exg,2,7,0,9,0.2222222222222222,0.2222222222222222,0.7777777777777778
2Eppw9WaWjc,14,11,3,28,0.5,0.5,0.39285714285714285
2ErVuPe4QQE,10,15,2,27,0.37037037037037035,0.37037037037037035,0.5555555555555556
2FQAOjQg_SM,7,10,0,17,0.4117647058823529,0.4117647058823529,0.5882352941176471
2FgueLN0p_c,18,4,3,25,0.72,0.72,0.16
2FoEmmmsmPY,34,59,6,99,0.3434343434343434,0.3434343434343434,0.5959595959595959
2Fvk_27c7dQ,11,25,6,42,0.2619047619047619,0.2619047619047619,0.5952380952380952
2GHb0Ba2928,7,16,3,26,0.2692307692307692,0.2692307692307692,0.6153846153846154
2JZWBW2bF_0,3,43,2,48,0.0625,0.0625,0.8958333333333334
2JgSogAA3G4,2,4,1,7,0.2857142857142857,0.2857142857142857,0.5714285714285714
2Jy5vpYYZuk,34,75,7,116,0.29310344827586204,0.29310344827586204,0.646551724137931
2K-cHC76_lA,9,7,2,18,0.5,0.5,0.3888888888888889
2KSHgS1Q7Ro,162,601,44,807,0.20074349442379183,0.20074349442379183,0.7447335811648079
2KmsjZsaG48,13,121,10,144,0.09027777777777778,0.09027777777777778,0.8402777777777778
2O-8_jHCjCI,5,42,5,52,0.09615384615384616,0.09615384615384616,0.8076923076923077
2Os0atQ8bco,44,70,8,122,0.36065573770491804,0.36065573770491804,0.5737704918032787
2PBXChn_ynw,29,95,3,127,0.2283464566929134,0.2283464566929134,0.7480314960629921
2Psg74r3k_o,54,145,26,225,0.24,0.24,0.6444444444444445
2QRMT5BD-iU,4,18,1,23,0.17391304347826086,0.17391304347826086,0.782608695652174
2Rn7l08Ybz0,3,12,2,17,0.17647058823529413,0.17647058823529413,0.7058823529411765
2Sh_HUMp5Mk,15,23,2,40,0.375,0.375,0.575
2WHD6XSHD5Y,11,46,12,69,0.15942028985507245,0.15942028985507245,0.6666666666666666
2YoMqnEDvVc,8,13,4,25,0.32,0.32,0.52
2_3sIKJRoYM,10,17,2,29,0.3448275862068966,0.3448275862068966,0.5862068965517241
2bXQfpH4i0c,4,7,0,11,0.36363636363636365,0.36363636363636365,0.6363636363636364
2cT22YVmQUg,139,137,41,317,0.4384858044164038,0.4384858044164038,0.43217665615141954
2d4MBINwu0Y,4,8,1,13,0.3076923076923077,0.3076923076923077,0.6153846153846154
2dNXRBtFl54,14,37,5,56,0.25,0.25,0.6607142857142857
2daNYnRugTA,7,20,0,27,0.25925925925925924,0.25925925925925924,0.7407407407407407
2e8d9t_GNBU,7,33,3,43,0.16279069767441862,0.16279069767441862,0.7674418604651163
2fsOU4qnX-o,21,31,1,53,0.39622641509433965,0.39622641509433965,0.5849056603773585
2gceC6e6RmE,8,16,6,30,0.26666666666666666,0.26666666666666666,0.5333333333333333
2ghdZGd0gjk,19,10,2,31,0.6129032258064516,0.6129032258064516,0.3225806451612903
2h0W2kampaI,13,64,4,81,0.16049382716049382,0.16049382716049382,0.7901234567901234
2jDGGy_fIN4,26,13,2,41,0.6341463414634146,0.6341463414634146,0.3170731707317073
2k5K7x8bJRI,30,11,5,46,0.6521739130434783,0.6521739130434783,0.2391304347826087
2kXzo3zBOBI,60,38,6,104,0.5769230769230769,0.5769230769230769,0.36538461538461536
2luIkwrIztY,9,11,2,22,0.4090909090909091,0.4090909090909091,0.5
2qeaW3NV3tg,2,0,0,2,1,1,0
2rSMAKkv8h0,5,5,4,14,0.35714285714285715,0.35714285714285715,0.35714285714285715
2ro6x_hFIKE,4,10,3,17,0.23529411764705882,0.23529411764705882,0.5882352941176471
2sg_dF529QU,11,43,2,56,0.19642857142857142,0.19642857142857142,0.7678571428571429
2tLtYqky4WU,95,497,59,651,0.14592933947772657,0.14592933947772657,0.7634408602150538
2tXMJa46nec,1,0,0,1,1,1,0
2tdWREbFt4g,30,39,1,70,0.42857142857142855,0.42857142857142855,0.5571428571428572
2u4wrCVf_Ng,2,5,1,8,0.25,0.25,0.625
2uHzkNEG10A,48,172,14,234,0.20512820512820512,0.20512820512820512,0.7350427350427351
2xFlhGEuW7Y,4,21,2,27,0.14814814814814814,0.14814814814814814,0.7777777777777778
2yHmf5Zkgc0,13,10,4,27,0.48148148148148145,0.48148148148148145,0.37037037037037035
3-JPKI3T2NY,30,26,7,63,0.47619047619047616,0.47619047619047616,0.4126984126984127
31uYLc6GcBY,22,152,6,180,0.12222222222222222,0.12222222222222222,0.8444444444444444
3298xSzcE_w,54,97,28,179,0.3016759776536313,0.3016759776536313,0.5418994413407822
32M3jHrXZZc,11,29,5,45,0.24444444444444444,0.24444444444444444,0.6444444444444445
32ar2fr4aK4,5,7,1,13,0.38461538461538464,0.38461538461538464,0.5384615384615384
34Kji5wgjeg,13,9,1,23,0.5652173913043478,0.5652173913043478,0.391304347826087
34ue5BGvbTA,22,34,5,61,0.36065573770491804,0.36065573770491804,0.5573770491803278
37-AFhTYK78,4,3,1,8,0.5,0.5,0.375
396kwEZ8wQs,40,60,9,109,0.3669724770642202,0.3669724770642202,0.5504587155963303
3B_79FpKrQk,9,43,4,56,0.16071428571428573,0.16071428571428573,0.7678571428571429
3CuF5dL8I9o,48,74,8,130,0.36923076923076925,0.36923076923076925,0.5692307692307692
3FwEL2KX_SE,59,127,24,210,0.28095238095238095,0.28095238095238095,0.6047619047619047
3J7Hu52gKzw,14,76,12,102,0.13725490196078433,0.13725490196078433,0.7450980392156863
3KXEGloXO9I,9,11,0,20,0.45,0.45,0.55
3L3v_OHeWwE,6,24,6,36,0.16666666666666666,0.16666666666666666,0.6666666666666666
3LGA0fgfZUk,2,14,2,18,0.1111111111111111,0.1111111111111111,0.7777777777777778
3LMh1zUZ2gM,11,5,0,16,0.6875,0.6875,0.3125
3Le7eK0j9b4,14,21,3,38,0.3684210526315789,0.3684210526315789,0.5526315789473685
3OL0ui4fHcY,14,14,2,30,0.4666666666666667,0.4666666666666667,0.4666666666666667
3QaM4qHYaQQ,4,6,0,10,0.4,0.4,0.6
3RUsb9-Yd70,18,30,7,55,0.32727272727272727,0.32727272727272727,0.5454545454545454
3TpbysrFOpk,2,11,0,13,0.15384615384615385,0.15384615384615385,0.8461538461538461
3ULcoRXwMVk,8,6,1,15,0.5333333333333333,0.5333333333333333,0.4
3Vu5MBbeNvo,19,76,18,113,0.168141592920354,0.168141592920354,0.672566371681416
3WKmNf_UOeo,2,6,0,8,0.25,0.25,0.75
3WQfSgXzflU,281,74,24,379,0.741424802110818,0.741424802110818,0.19525065963060687
3XdcLy1XAjU,19,9,3,31,0.6129032258064516,0.6129032258064516,0.2903225806451613
3YXAwbRdfhk,11,18,0,29,0.3793103448275862,0.3793103448275862,0.6206896551724138
3ZeOMwYXXuw,5,15,5,25,0.2,0.2,0.6
3_6I1wGJ_vY,25,17,3,45,0.5555555555555556,0.5555555555555556,0.37777777777777777
3aAcfFRFg0Y,17,17,2,36,0.4722222222222222,0.4722222222222222,0.4722222222222222
3b1_MScwu8E,11,27,1,39,0.28205128205128205,0.28205128205128205,0.6923076923076923
3c2m8Hv6-lU,33,71,6,110,0.3,0.3,0.6454545454545455
3cKDW-hKfhk,15,24,1,40,0.375,0.375,0.6
3dLsi92Dy-w,2,27,1,30,0.06666666666666667,0.06666666666666667,0.9
3eRuHEN0-8E,1,2,0,3,0.3333333333333333,0.3333333333333333,0.6666666666666666
3ehzg9clPlE,21,30,5,56,0.375,0.375,0.5357142857142857
3fbp8_aSBV4,114,443,117,674,0.16913946587537093,0.16913946587537093,0.6572700296735905
3fje2sARgYg,8,1,1,10,0.8,0.8,0.1
3fsUSaLxKIo,12,28,4,44,0.2727272727272727,0.2727272727272727,0.6363636363636364
3gF_r5_YgdM,87,104,19,210,0.4142857142857143,0.4142857142857143,0.49523809523809526
3hBK8B4lDsU,17,25,2,44,0.38636363636363635,0.38636363636363635,0.5681818181818182
3hnrd2zJTJY,12,17,2,31,0.3870967741935484,0.3870967741935484,0.5483870967741935
3iMkXV_WH1g,51,52,17,120,0.425,0.425,0.43333333333333335
3l9aGpdoNBI,4,5,0,9,0.4444444444444444,0.4444444444444444,0.5555555555555556
3lPg0NHAycs,6,12,2,20,0.3,0.3,0.6
3lklG3rNoSs,6,11,1,18,0.3333333333333333,0.3333333333333333,0.6111111111111112
3n74siNEI0o,16,20,1,37,0.43243243243243246,0.43243243243243246,0.5405405405405406
3oByKYlsplg,63,67,5,135,0.4666666666666667,0.4666666666666667,0.4962962962962963
3p5LDLLFVdE,10,20,3,33,0.30303030303030304,0.30303030303030304,0.6060606060606061
3qNh8dbdGhw,18,25,0,43,0.4186046511627907,0.4186046511627907,0.5813953488372093
3rAFyjMFJwI,34,42,2,78,0.4358974358974359,0.4358974358974359,0.5384615384615384
3u0G6HUMRsM,5,14,0,19,0.2631578947368421,0.2631578947368421,0.7368421052631579
3uoz54-uiXY,5,12,0,17,0.29411764705882354,0.29411764705882354,0.7058823529411765
3v7GaFS8GqM,7,9,2,18,0.3888888888888889,0.3888888888888889,0.5
3wluTdmiFUQ,5,1,0,6,0.8333333333333334,0.8333333333333334,0.16666666666666666
3xJby7SBhlI,21,39,1,61,0.3442622950819672,0.3442622950819672,0.639344262295082
3xWRu0tCacw,10,31,3,44,0.22727272727272727,0.22727272727272727,0.7045454545454546
40pcOriGCRY,6,50,4,60,0.1,0.1,0.8333333333333334
41p2oth17zs,7,11,3,21,0.3333333333333333,0.3333333333333333,0.5238095238095238
45sPJvFhIxE,7,9,7,23,0.30434782608695654,0.30434782608695654,0.391304347826087
47JWg9HORIg,2,4,1,7,0.2857142857142857,0.2857142857142857,0.5714285714285714
49IqaiU8CZ0,1,7,0,8,0.125,0.125,0.875
49QCZO1zSaQ,11,22,2,35,0.3142857142857143,0.3142857142857143,0.6285714285714286
4A-fmuLfMAw,71,32,2,105,0.6761904761904762,0.6761904761904762,0.3047619047619048
4AmFT9qbkYw,3,2,1,6,0.5,0.5,0.3333333333333333
4BYDgd9YSMw,7,29,0,36,0.19444444444444445,0.19444444444444445,0.8055555555555556
4CGrvFwnaG8,5,17,2,24,0.20833333333333334,0.20833333333333334,0.7083333333333334
4ECzS7TxHxM,8,8,3,19,0.42105263157894735,0.42105263157894735,0.42105263157894735
4GTyJfdMvVg,62,62,8,132,0.4696969696969697,0.4696969696969697,0.4696969696969697
4HATT6btE0E,10,7,0,17,0.5882352941176471,0.5882352941176471,0.4117647058823529
4LVEnlSbCm0,5,29,0,34,0.14705882352941177,0.14705882352941177,0.8529411764705882
4Loykvx0AtY,16,25,4,45,0.35555555555555557,0.35555555555555557,0.5555555555555556
4MTgAXkxv64,11,21,1,33,0.3333333333333333,0.3333333333333333,0.6363636363636364
4MxCTGGLOQA,61,100,7,168,0.3630952380952381,0.3630952380952381,0.5952380952380952
4OPv8yznuow,4,2,0,6,0.6666666666666666,0.6666666666666666,0.3333333333333333
4Om1rlUKVsU,4,12,1,17,0.23529411764705882,0.23529411764705882,0.7058823529411765
4P_FV7uxiuY,14,33,2,49,0.2857142857142857,0.2857142857142857,0.673469387755102
4QtiiNhzlPg,2,1,1,4,0.5,0.5,0.25
4RpUrhpxdTg,10,10,5,25,0.4,0.4,0.4
4SGIOUOgdSE,36,75,9,120,0.3,0.3,0.625
4SasBd9Nc04,0,4,1,5,0,0,0.8
4SdG5DgoUa8,9,24,3,36,0.25,0.25,0.6666666666666666
4Set9kVU7qo,5,9,0,14,0.35714285714285715,0.35714285714285715,0.6428571428571429
4Tjm5ZDQ8_I,8,9,1,18,0.4444444444444444,0.4444444444444444,0.5
4VCSl2qM7j4,5,12,0,17,0.29411764705882354,0.29411764705882354,0.7058823529411765
4VYHKBdOeX0,89,93,6,188,0.4734042553191489,0.4734042553191489,0.4946808510638298
4WF7pGWGBfs,14,13,3,30,0.4666666666666667,0.4666666666666667,0.43333333333333335
4WLEwE3R5yM,11,16,1,28,0.39285714285714285,0.39285714285714285,0.5714285714285714
4WTn7dpu7fg,24,23,6,53,0.4528301886792453,0.4528301886792453,0.4339622641509434
4XUW7ZXsANg,3,6,1,10,0.3,0.3,0.6
4_LOC2Ya6eI,7,6,1,14,0.5,0.5,0.42857142857142855
4bUM3H3ADvE,17,16,1,34,0.5,0.5,0.47058823529411764
4cUEf6w0Feg,33,64,5,102,0.3235294117647059,0.3235294117647059,0.6274509803921569
4cvIA6jPR94,125,99,21,245,0.5102040816326531,0.5102040816326531,0.40408163265306124
4h6J0wM-I_Q,39,245,24,308,0.1266233766233766,0.1266233766233766,0.7954545454545454
4j4r3xd0Ico,58,255,13,326,0.17791411042944785,0.17791411042944785,0.7822085889570553
4jZDXlZ3MK0,19,4,1,24,0.7916666666666666,0.7916666666666666,0.16666666666666666
4jzlFxYCGbk,89,182,18,289,0.3079584775086505,0.3079584775086505,0.629757785467128
4lfUpHhcdOw,19,56,8,83,0.2289156626506024,0.2289156626506024,0.6746987951807228
4lhe77wqCis,24,14,5,43,0.5581395348837209,0.5581395348837209,0.32558139534883723
4nZklX4_31w,24,86,3,113,0.21238938053097345,0.21238938053097345,0.7610619469026548
4oaEOt9kXg0,10,29,2,41,0.24390243902439024,0.24390243902439024,0.7073170731707317
4p63QBG3jnY,6,8,0,14,0.42857142857142855,0.42857142857142855,0.5714285714285714
4pVaNM3F4VE,23,24,2,49,0.46938775510204084,0.46938775510204084,0.4897959183673469
4pYbRup6bLA,13,21,3,37,0.35135135135135137,0.35135135135135137,0.5675675675675675
4rJuyWTr8Y4,15,36,4,55,0.2727272727272727,0.2727272727272727,0.6545454545454545
4rMT5z7vL8Y,11,19,0,30,0.36666666666666664,0.36666666666666664,0.6333333333333333
4rtDhH2fDgs,49,83,11,143,0.34265734265734266,0.34265734265734266,0.5804195804195804
4sGk5slybB0,7,9,3,19,0.3684210526315789,0.3684210526315789,0.47368421052631576
4sQZCirL6go,9,7,0,16,0.5625,0.5625,0.4375
4sukUGGl_P0,33,28,1,62,0.532258064516129,0.532258064516129,0.45161290322580644
4tRveTi9tlA,34,7,1,42,0.8095238095238095,0.8095238095238095,0.16666666666666666
4wmH6vygf-w,6,19,3,28,0.21428571428571427,0.21428571428571427,0.6785714285714286
4xfk2bKeif4,9,9,1,19,0.47368421052631576,0.47368421052631576,0.47368421052631576
4yd_RjtirgM,15,7,6,28,0.5357142857142857,0.5357142857142857,0.25
4zAhgcOzacs,2,1,1,4,0.5,0.5,0.25
4zbqI9s8y9o,21,102,10,133,0.15789473684210525,0.15789473684210525,0.7669172932330827
5-kVfNBRfQw,5,14,0,19,0.2631578947368421,0.2631578947368421,0.7368421052631579
50L7U0UftGM,7,20,2,29,0.2413793103448276,0.2413793103448276,0.6896551724137931
50bEKLDeNX4,10,9,0,19,0.5263157894736842,0.5263157894736842,0.47368421052631576
51c7oqhuHE0,18,10,2,30,0.6,0.6,0.3333333333333333
537x32w3_iw,251,748,181,1180,0.21271186440677967,0.21271186440677967,0.6338983050847458
53TFh1eJhg4,10,41,0,51,0.19607843137254902,0.19607843137254902,0.803921568627451
55gD7vFognU,113,25,5,143,0.7902097902097902,0.7902097902097902,0.17482517482517482
56SAoPyW4no,10,55,3,68,0.14705882352941177,0.14705882352941177,0.8088235294117647
57INStrN5hg,6,44,2,52,0.11538461538461539,0.11538461538461539,0.8461538461538461
59ewYY3ZPLo,4,10,3,17,0.23529411764705882,0.23529411764705882,0.5882352941176471
59wvxGMeW18,5,17,2,24,0.20833333333333334,0.20833333333333334,0.7083333333333334
5B2msNaQ7Ao,7,10,2,19,0.3684210526315789,0.3684210526315789,0.5263157894736842
5Bh8NrOyHuI,17,6,3,26,0.6538461538461539,0.6538461538461539,0.23076923076923078
5BphR0eozHI,56,53,7,116,0.4827586206896552,0.4827586206896552,0.45689655172413796
5CqyBDDCj6A,4,14,1,19,0.21052631578947367,0.21052631578947367,0.7368421052631579
5EHURXBR1rQ,5,3,1,9,0.5555555555555556,0.5555555555555556,0.3333333333333333
5EyNP_uDkKk,22,39,4,65,0.3384615384615385,0.3384615384615385,0.6
5Fp0V-8xFh8,43,102,19,164,0.2621951219512195,0.2621951219512195,0.6219512195121951
5H1wVi-_bK8,11,18,4,33,0.3333333333333333,0.3333333333333333,0.5454545454545454
5IFN-9wr-J8,8,25,2,35,0.22857142857142856,0.22857142857142856,0.7142857142857143
5IqCb3cX5xA,4,2,1,7,0.5714285714285714,0.5714285714285714,0.2857142857142857
5J56olg0_qM,17,30,0,47,0.3617021276595745,0.3617021276595745,0.6382978723404256
5K8VBiLy57k,2,12,0,14,0.14285714285714285,0.14285714285714285,0.8571428571428571
5KXlBaFu2KU,11,22,5,38,0.2894736842105263,0.2894736842105263,0.5789473684210527
5LNdO7cjsXk,30,53,6,89,0.33707865168539325,0.33707865168539325,0.5955056179775281
5M2_ESh9mHU,3,15,0,18,0.16666666666666666,0.16666666666666666,0.8333333333333334
5PGALEchu4U,12,45,0,57,0.21052631578947367,0.21052631578947367,0.7894736842105263
5QBIECe4k8c,13,26,4,43,0.3023255813953488,0.3023255813953488,0.6046511627906976
5RwAR7yDs5E,2,28,0,30,0.06666666666666667,0.06666666666666667,0.9333333333333333
5SqIv9WmpPw,295,240,29,564,0.5230496453900709,0.5230496453900709,0.425531914893617
5U3FDM3fOO8,44,47,6,97,0.4536082474226804,0.4536082474226804,0.4845360824742268
5U6WRIIkjWM,17,25,1,43,0.3953488372093023,0.3953488372093023,0.5813953488372093
5UsUpJao3Co,34,60,13,107,0.3177570093457944,0.3177570093457944,0.5607476635514018
5VXJCp01_-0,32,82,7,121,0.2644628099173554,0.2644628099173554,0.6776859504132231
5X7-6kjQSRU,7,42,7,56,0.125,0.125,0.75
5XJJ_XUi7H4,6,28,2,36,0.16666666666666666,0.16666666666666666,0.7777777777777778
5XW_yVEACJI,30,41,1,72,0.4166666666666667,0.4166666666666667,0.5694444444444444
5Yvsh1Lt8dE,7,16,1,24,0.2916666666666667,0.2916666666666667,0.6666666666666666
5ZAQ4ay4nak,95,69,20,184,0.5163043478260869,0.5163043478260869,0.375
5_tYMPlRaO4,16,32,4,52,0.3076923076923077,0.3076923076923077,0.6153846153846154
5cyu2Qs3YP4,15,7,1,23,0.6521739130434783,0.6521739130434783,0.30434782608695654
5ddySnYqftA,2,0,0,2,1,1,0
5eM2DAv5MMw,29,54,2,85,0.3411764705882353,0.3411764705882353,0.6352941176470588
5fqQV6f7wqo,5,6,0,11,0.45454545454545453,0.45454545454545453,0.5454545454545454
5hB_ySpHpNI,7,22,0,29,0.2413793103448276,0.2413793103448276,0.7586206896551724
5hGMW3L-B8w,105,375,45,525,0.2,0.2,0.7142857142857143
5kBmeHWNTIE,91,345,40,476,0.19117647058823528,0.19117647058823528,0.7247899159663865
5kRmcwX_VyU,1,12,1,14,0.07142857142857142,0.07142857142857142,0.8571428571428571
5kY1kJeMfvI,32,121,16,169,0.1893491124260355,0.1893491124260355,0.7159763313609467
5khVBaIiSb0,12,4,1,17,0.7058823529411765,0.7058823529411765,0.23529411764705882
5l1lrRtgnSg,10,19,2,31,0.3225806451612903,0.3225806451612903,0.6129032258064516
5mWAVMKwCA4,9,19,3,31,0.2903225806451613,0.2903225806451613,0.6129032258064516
5mdK_K-_2Ug,48,68,7,123,0.3902439024390244,0.3902439024390244,0.5528455284552846
5nX2yQS9GEQ,8,31,7,46,0.17391304347826086,0.17391304347826086,0.6739130434782609
5oD2ysHTHlc,4,5,1,10,0.4,0.4,0.5
5oDJlXoMvvk,6,9,1,16,0.375,0.375,0.5625
5ozc70WA3WI,21,25,10,56,0.375,0.375,0.44642857142857145
5vCWGh3eoNE,1,4,2,7,0.14285714285714285,0.14285714285714285,0.5714285714285714
5vjFDkykrQo,4,4,1,9,0.4444444444444444,0.4444444444444444,0.4444444444444444
5x6wdntoidA,62,166,12,240,0.25833333333333336,0.25833333333333336,0.6916666666666667
5yR36wBMwtw,8,29,2,39,0.20512820512820512,0.20512820512820512,0.7435897435897436
5yV_R0G7pvU,11,15,4,30,0.36666666666666664,0.36666666666666664,0.5
6-f4O8VxRGI,8,7,0,15,0.5333333333333333,0.5333333333333333,0.4666666666666667
608B0nj9Rjk,35,22,3,60,0.5833333333333334,0.5833333333333334,0.36666666666666664
60mF-ooKpNA,9,27,9,45,0.2,0.2,0.6
63ySVBUtlGs,22,7,2,31,0.7096774193548387,0.7096774193548387,0.22580645161290322
66cv0PCnRnk,13,4,0,17,0.7647058823529411,0.7647058823529411,0.23529411764705882
66jPJUfIMgw,5,13,0,18,0.2777777777777778,0.2777777777777778,0.7222222222222222
68SeCQdSxrc,14,9,2,25,0.56,0.56,0.36
6A7DrGxC1cA,6,34,1,41,0.14634146341463414,0.14634146341463414,0.8292682926829268
6Bkt85atwuI,3,23,3,29,0.10344827586206896,0.10344827586206896,0.7931034482758621
6BxAzyu-yvI,181,129,8,318,0.5691823899371069,0.5691823899371069,0.4056603773584906
6DVfJLt5r_M,3,12,0,15,0.2,0.2,0.8
6EJrAQx2WZI,11,43,0,54,0.2037037037037037,0.2037037037037037,0.7962962962962963
6ETs-EcZMWE,9,91,9,109,0.08256880733944955,0.08256880733944955,0.8348623853211009
6EgVgEhscg0,46,198,20,264,0.17424242424242425,0.17424242424242425,0.75
6FcpFwCEG1Y,20,12,2,34,0.5882352941176471,0.5882352941176471,0.35294117647058826
6H9uNF0IzLM,3,22,3,28,0.10714285714285714,0.10714285714285714,0.7857142857142857
6ImnB7cESmo,4,9,0,13,0.3076923076923077,0.3076923076923077,0.6923076923076923
6JISCow4klw,9,21,0,30,0.3,0.3,0.7
6JM540qV8r8,6,11,0,17,0.35294117647058826,0.35294117647058826,0.6470588235294118
6JSkD7JF4Ck,512,743,137,1392,0.367816091954023,0.367816091954023,0.5337643678160919
6JkVW-3cbLg,3,2,0,5,0.6,0.6,0.4
6L9Y2qDjkWc,36,133,20,189,0.19047619047619047,0.19047619047619047,0.7037037037037037
6LIg9iumFRk,122,428,16,566,0.21554770318021202,0.21554770318021202,0.7561837455830389
6LLxbZPiTlM,0,3,0,3,0,0,1
6LYnAWOiLhQ,18,51,7,76,0.23684210526315788,0.23684210526315788,0.6710526315789473
6LyGkpMroA8,10,7,4,21,0.47619047619047616,0.47619047619047616,0.3333333333333333
6NC9VPJteTI,66,40,9,115,0.5739130434782609,0.5739130434782609,0.34782608695652173
6OGDQN0S694,126,81,13,220,0.5727272727272728,0.5727272727272728,0.36818181818181817
6R-cW36PDO0,128,161,19,308,0.4155844155844156,0.4155844155844156,0.5227272727272727
6S5C8wZ_iIY,21,31,4,56,0.375,0.375,0.5535714285714286
6SEgfPioKuA,15,17,3,35,0.42857142857142855,0.42857142857142855,0.4857142857142857
6T8RiTFdwCM,8,9,1,18,0.4444444444444444,0.4444444444444444,0.5
6UprCsGLr3M,14,27,0,41,0.34146341463414637,0.34146341463414637,0.6585365853658537
6VH-Xi85Tu4,22,27,4,53,0.41509433962264153,0.41509433962264153,0.5094339622641509
6V_I-j4C0Tk,14,15,1,30,0.4666666666666667,0.4666666666666667,0.5
6XmW5nnwVqE,17,85,5,107,0.1588785046728972,0.1588785046728972,0.794392523364486
6XzTj1dCEu0,9,8,3,20,0.45,0.45,0.4
6YEkBH3V-oQ,7,23,4,34,0.20588235294117646,0.20588235294117646,0.6764705882352942
6YHbnQkFI0Q,8,64,11,83,0.0963855421686747,0.0963855421686747,0.7710843373493976
6YJRcJ5GPfY,59,121,15,195,0.30256410256410254,0.30256410256410254,0.6205128205128205
6YNJnDSBXcs,11,15,3,29,0.3793103448275862,0.3793103448275862,0.5172413793103449
6YcamovsA10,3,15,1,19,0.15789473684210525,0.15789473684210525,0.7894736842105263
6ZEdWXv6OO4,10,5,1,16,0.625,0.625,0.3125
6ZVaDA-kzq0,10,15,0,25,0.4,0.4,0.6
6_8Uf7EgBco,4,35,0,39,0.10256410256410256,0.10256410256410256,0.8974358974358975
6_Mxo0Eo6Jg,62,107,6,175,0.35428571428571426,0.35428571428571426,0.6114285714285714
6_YK0komgUM,3,17,3,23,0.13043478260869565,0.13043478260869565,0.7391304347826086
6b9GDhh1kmM,21,64,5,90,0.23333333333333334,0.23333333333333334,0.7111111111111111
6cmWxP_-CR8,13,17,3,33,0.3939393939393939,0.3939393939393939,0.5151515151515151
6e2_0MfDN1c,4,7,2,13,0.3076923076923077,0.3076923076923077,0.5384615384615384
6e43F9eiMYA,33,46,4,83,0.39759036144578314,0.39759036144578314,0.5542168674698795
6erBweMyU0Q,51,25,2,78,0.6538461538461539,0.6538461538461539,0.32051282051282054
6f10NV9S4sQ,38,11,2,51,0.7450980392156863,0.7450980392156863,0.21568627450980393
6g4c-kHQAWM,24,32,1,57,0.42105263157894735,0.42105263157894735,0.5614035087719298
6il5GObcVUo,4,8,0,12,0.3333333333333333,0.3333333333333333,0.6666666666666666
6jGUMah9Vso,19,42,5,66,0.2878787878787879,0.2878787878787879,0.6363636363636364
6jum0r1z6I4,33,57,9,99,0.3333333333333333,0.3333333333333333,0.5757575757575758
6jw1GDin9_A,21,112,18,151,0.1390728476821192,0.1390728476821192,0.7417218543046358
6lGgwqNe9Os,7,20,1,28,0.25,0.25,0.7142857142857143
6lZKJixX0FI,20,51,4,75,0.26666666666666666,0.26666666666666666,0.68
6mY6G7dLWT8,1,1,1,3,0.3333333333333333,0.3333333333333333,0.3333333333333333
6n_lkQuuBd8,5,28,2,35,0.14285714285714285,0.14285714285714285,0.8
6p9ObZBjVvs,25,97,11,133,0.18796992481203006,0.18796992481203006,0.7293233082706767
6plYLxoZItM,74,264,12,350,0.21142857142857144,0.21142857142857144,0.7542857142857143
6r66H0-NRV8,12,17,1,30,0.4,0.4,0.5666666666666667
6tJvQu1M3O0,38,128,20,186,0.20430107526881722,0.20430107526881722,0.6881720430107527
6tK2S6jOgj0,15,8,1,24,0.625,0.625,0.3333333333333333
6vXeYaP1LAo,38,37,8,83,0.4578313253012048,0.4578313253012048,0.4457831325301205
6vmkE7iypo8,9,19,7,35,0.2571428571428571,0.2571428571428571,0.5428571428571428
6wCrJN3aclc,4,1,0,5,0.8,0.8,0.2
6wZbv-3sh3w,21,50,8,79,0.26582278481012656,0.26582278481012656,0.6329113924050633
6wanE0rZuP0,14,92,16,122,0.11475409836065574,0.11475409836065574,0.7540983606557377
6zsSAb64EnM,56,43,3,102,0.5490196078431373,0.5490196078431373,0.4215686274509804
71ODZ21jeOU,22,20,2,44,0.5,0.5,0.45454545454545453
72KII-qwdBI,14,73,2,89,0.15730337078651685,0.15730337078651685,0.8202247191011236
731dxTk1EI8,3,3,2,8,0.375,0.375,0.375
74p3g-2odzg,40,32,2,74,0.5405405405405406,0.5405405405405406,0.43243243243243246
75E1rxM8PxU,3,5,1,9,0.3333333333333333,0.3333333333333333,0.5555555555555556
76f8w_ZoEWI,1,5,0,6,0.16666666666666666,0.16666666666666666,0.8333333333333334
76wULENSjjY,41,74,6,121,0.33884297520661155,0.33884297520661155,0.6115702479338843
774EKBWZgN4,85,258,9,352,0.24147727272727273,0.24147727272727273,0.7329545454545454
77Nce18R7rU,55,161,14,230,0.2391304347826087,0.2391304347826087,0.7
77qtbn5p1BM,10,21,4,35,0.2857142857142857,0.2857142857142857,0.6
77s5puwx94E,11,32,6,49,0.22448979591836735,0.22448979591836735,0.6530612244897959
77xRdjMmuiQ,2,14,1,17,0.11764705882352941,0.11764705882352941,0.8235294117647058
7853UwnaJiw,102,107,15,224,0.45535714285714285,0.45535714285714285,0.47767857142857145
78jYBV-UNc8,2,5,0,7,0.2857142857142857,0.2857142857142857,0.7142857142857143
795IzoZNh6s,7,15,0,22,0.3181818181818182,0.3181818181818182,0.6818181818181818
7Cw3SCgWqjo,6,15,1,22,0.2727272727272727,0.2727272727272727,0.6818181818181818
7F4ljL-mbts,17,29,2,48,0.3541666666666667,0.3541666666666667,0.6041666666666666
7FWyqMpbEDs,7,8,1,16,0.4375,0.4375,0.5
7G7LzRkiuJY,11,42,1,54,0.2037037037037037,0.2037037037037037,0.7777777777777778
7GDeXHMNQ4g,37,47,6,90,0.4111111111111111,0.4111111111111111,0.5222222222222223
7GYkgcCzs8M,1,8,0,9,0.1111111111111111,0.1111111111111111,0.8888888888888888
7GqWNK1MFEA,6,13,3,22,0.2727272727272727,0.2727272727272727,0.5909090909090909
7IpQsGoWwX4,5,11,6,22,0.22727272727272727,0.22727272727272727,0.5
7JDFkG0vG5g,3,10,0,13,0.23076923076923078,0.23076923076923078,0.7692307692307693
7L99MnvaUTs,14,15,5,34,0.4117647058823529,0.4117647058823529,0.4411764705882353
7LaC6P6fSuo,27,18,4,49,0.5510204081632653,0.5510204081632653,0.3673469387755102
7NLN6BNcfKQ,4,4,0,8,0.5,0.5,0.5
7OtDELu6g48,7,26,4,37,0.1891891891891892,0.1891891891891892,0.7027027027027027
7Q1TrnJjRI0,62,243,4,309,0.20064724919093851,0.20064724919093851,0.7864077669902912
7R6uDmWros4,68,59,6,133,0.5112781954887218,0.5112781954887218,0.44360902255639095
7SFnVfp2rTQ,54,44,5,103,0.5242718446601942,0.5242718446601942,0.42718446601941745
7UCqBnVs8WM,4,24,1,29,0.13793103448275862,0.13793103448275862,0.8275862068965517
7Uf20VIndAw,10,26,7,43,0.23255813953488372,0.23255813953488372,0.6046511627906976
7Wv4G0nJcJE,8,5,0,13,0.6153846153846154,0.6153846153846154,0.38461538461538464
7WztszhwVlU,10,46,1,57,0.17543859649122806,0.17543859649122806,0.8070175438596491
7X5-Yh9rlwo,8,46,5,59,0.13559322033898305,0.13559322033898305,0.7796610169491526
7Xmh1P1jjbM,9,14,2,25,0.36,0.36,0.56
7Z1-gNhADm8,8,3,0,11,0.7272727272727273,0.7272727272727273,0.2727272727272727
7ZZGNXBfINg,32,65,20,117,0.27350427350427353,0.27350427350427353,0.5555555555555556
7_3kPQfp6dI,20,24,3,47,0.425531914893617,0.425531914893617,0.5106382978723404
7av7zCo2OvM,24,28,8,60,0.4,0.4,0.4666666666666667
7ccorgUDU64,8,39,4,51,0.1568627450980392,0.1568627450980392,0.7647058823529411
7doYX5kebxE,175,153,26,354,0.4943502824858757,0.4943502824858757,0.4322033898305085
7e19q0k4YpE,19,5,3,27,0.7037037037037037,0.7037037037037037,0.18518518518518517
7e_s7CUJos0,1,4,1,6,0.16666666666666666,0.16666666666666666,0.6666666666666666
7fSLs4MgXV4,27,26,5,58,0.46551724137931033,0.46551724137931033,0.4482758620689655
7furKyiUzGc,8,12,2,22,0.36363636363636365,0.36363636363636365,0.5454545454545454
7gDmC3MJ9Yk,7,6,0,13,0.5384615384615384,0.5384615384615384,0.46153846153846156
7hHPCjXppL8,9,22,3,34,0.2647058823529412,0.2647058823529412,0.6470588235294118
7hZ-5M7UQQ0,8,11,2,21,0.38095238095238093,0.38095238095238093,0.5238095238095238
7i1bqMsxURg,8,9,1,18,0.4444444444444444,0.4444444444444444,0.5
7iHQS1zgc-o,26,66,7,99,0.26262626262626265,0.26262626262626265,0.6666666666666666
7kHyJOhJDHk,22,29,3,54,0.4074074074074074,0.4074074074074074,0.5370370370370371
7moMgFDOCf0,0,2,1,3,0,0,0.6666666666666666
7nCYw_lY31U,5,5,0,10,0.5,0.5,0.5
7o-RP_tOjr4,4,14,0,18,0.2222222222222222,0.2222222222222222,0.7777777777777778
7oCazA362Us,17,47,7,71,0.23943661971830985,0.23943661971830985,0.6619718309859155
7oYfcM1XRyQ,39,170,13,222,0.17567567567567569,0.17567567567567569,0.7657657657657657
7piE1IayceI,14,27,2,43,0.32558139534883723,0.32558139534883723,0.627906976744186
7ptRLvwj4Xo,18,46,5,69,0.2608695652173913,0.2608695652173913,0.6666666666666666
7s7Ey_yTflo,77,69,7,153,0.5032679738562091,0.5032679738562091,0.45098039215686275
7t-NQ3e18rw,3,0,0,3,1,1,0
7tJWbUrmOew,7,3,1,11,0.6363636363636364,0.6363636363636364,0.2727272727272727
7u6jrdrhvUQ,7,26,4,37,0.1891891891891892,0.1891891891891892,0.7027027027027027
7vdYZS7unn8,15,22,3,40,0.375,0.375,0.55
7w80O3Ujl2s,4,16,3,23,0.17391304347826086,0.17391304347826086,0.6956521739130435
7x7Hur_lLvo,19,49,7,75,0.25333333333333335,0.25333333333333335,0.6533333333333333
7xBlq6sVmfc,101,254,54,409,0.2469437652811736,0.2469437652811736,0.6210268948655256
7xOmn41kx8E,16,46,4,66,0.24242424242424243,0.24242424242424243,0.696969696969697
7xeteXfQUx0,20,17,14,51,0.39215686274509803,0.39215686274509803,0.3333333333333333
7zwEhwIykoI,1,2,0,3,0.3333333333333333,0.3333333333333333,0.6666666666666666
8-I6LBoOL70,2,4,0,6,0.3333333333333333,0.3333333333333333,0.6666666666666666
816kZzhM4us,11,64,6,81,0.13580246913580246,0.13580246913580246,0.7901234567901234
82Kh8VgrWi0,8,17,2,27,0.2962962962962963,0.2962962962962963,0.6296296296296297
82sCElY25FM,12,3,4,19,0.631578947368421,0.631578947368421,0.15789473684210525
858vEzxDveE,22,50,22,94,0.23404255319148937,0.23404255319148937,0.5319148936170213
86pl2ZoWO2M,7,11,2,20,0.35,0.35,0.55
8AGsAmqSkjw,11,31,5,47,0.23404255319148937,0.23404255319148937,0.6595744680851063
8AP9TvTRA6c,20,28,7,55,0.36363636363636365,0.36363636363636365,0.509090909090909
8C8kog0jaeY,3,1,1,5,0.6,0.6,0.2
8CDzZ7JKcHs,28,29,5,62,0.45161290322580644,0.45161290322580644,0.46774193548387094
8CEZTFwVVm4,18,52,6,76,0.23684210526315788,0.23684210526315788,0.6842105263157895
8D0gIZfR9HY,8,17,3,28,0.2857142857142857,0.2857142857142857,0.6071428571428571
8EZoIGCRx80,13,15,3,31,0.41935483870967744,0.41935483870967744,0.4838709677419355
8Fh4Cd9rkpE,2,5,0,7,0.2857142857142857,0.2857142857142857,0.7142857142857143
8G7hqHJFg_8,9,14,0,23,0.391304347826087,0.391304347826087,0.6086956521739131
8Gh-LqWPX00,19,59,5,83,0.2289156626506024,0.2289156626506024,0.7108433734939759
8Gk2CUW_dOI,44,26,4,74,0.5945945945945946,0.5945945945945946,0.35135135135135137
8H3_Q0x7P7E,20,31,1,52,0.38461538461538464,0.38461538461538464,0.5961538461538461
8HroXamBf9Q,1,6,1,8,0.125,0.125,0.75
8IDNc-GgP6M,6,15,3,24,0.25,0.25,0.625
8InhH9trvj8,83,84,3,170,0.48823529411764705,0.48823529411764705,0.49411764705882355
8JlOKvBkhsA,8,4,1,13,0.6153846153846154,0.6153846153846154,0.3076923076923077
8N8C56PBrv8,14,31,1,46,0.30434782608695654,0.30434782608695654,0.6739130434782609
8NexICntSC0,160,286,20,466,0.34334763948497854,0.34334763948497854,0.6137339055793991
8NsTdvsSjTU,10,25,0,35,0.2857142857142857,0.2857142857142857,0.7142857142857143
8Nt_2fZ6N1A,3,14,0,17,0.17647058823529413,0.17647058823529413,0.8235294117647058
8PsVGqdfavg,46,21,4,71,0.647887323943662,0.647887323943662,0.29577464788732394
8Q1rq2_NNjc,17,19,2,38,0.4473684210526316,0.4473684210526316,0.5
8Q4EnuE_UnM,11,19,0,30,0.36666666666666664,0.36666666666666664,0.6333333333333333
8RVr-K28Ulc,9,27,2,38,0.23684210526315788,0.23684210526315788,0.7105263157894737
8Re_JCCH-Qc,82,762,27,871,0.09414466130884042,0.09414466130884042,0.8748564867967853
8S7ipqgc9VI,158,358,76,592,0.2668918918918919,0.2668918918918919,0.6047297297297297
8SEqRNQ2cEc,8,0,0,8,1,1,0
8T6Zn3r4RkQ,18,60,1,79,0.22784810126582278,0.22784810126582278,0.759493670886076
8T9f7zc_clo,30,100,11,141,0.2127659574468085,0.2127659574468085,0.7092198581560284
8TJfdCHiLbI,12,15,3,30,0.4,0.4,0.5
8UOokHm1KK8,15,8,0,23,0.6521739130434783,0.6521739130434783,0.34782608695652173
8W4qxyHyMxI,10,8,3,21,0.47619047619047616,0.47619047619047616,0.38095238095238093
8X1nKROCONo,1,13,1,15,0.06666666666666667,0.06666666666666667,0.8666666666666667
8YNREdewGf0,20,16,4,40,0.5,0.5,0.4
8YOZYEjGrL0,10,20,3,33,0.30303030303030304,0.30303030303030304,0.6060606060606061
8YQs-osxcf8,1,2,0,3,0.3333333333333333,0.3333333333333333,0.6666666666666666
8Y_2BDiJOac,6,2,1,9,0.6666666666666666,0.6666666666666666,0.2222222222222222
8Z0pHsBbRMs,68,115,20,203,0.33497536945812806,0.33497536945812806,0.5665024630541872
8ajvzKU_U_M,4,10,0,14,0.2857142857142857,0.2857142857142857,0.7142857142857143
8d8H26RpANk,23,57,8,88,0.26136363636363635,0.26136363636363635,0.6477272727272727
8e4KXV7rqjg,16,11,3,30,0.5333333333333333,0.5333333333333333,0.36666666666666664
8ee5StMNLug,19,27,2,48,0.3958333333333333,0.3958333333333333,0.5625
8fUarwIi3n4,67,427,51,545,0.12293577981651377,0.12293577981651377,0.7834862385321101
8gwUIj_c7PE,5,16,3,24,0.20833333333333334,0.20833333333333334,0.6666666666666666
8h3_gCWnVQg,3,7,1,11,0.2727272727272727,0.2727272727272727,0.6363636363636364
8hI1p2EDJK8,24,20,6,50,0.48,0.48,0.4
8jHVu0sFeNI,8,8,1,17,0.47058823529411764,0.47058823529411764,0.47058823529411764
8jXSgMRStCI,20,13,3,36,0.5555555555555556,0.5555555555555556,0.3611111111111111
8k3kAk2RrOo,4,20,3,27,0.14814814814814814,0.14814814814814814,0.7407407407407407
8kHx70vRJIg,9,11,0,20,0.45,0.45,0.55
8mcMb5JMPuE,5,20,2,27,0.18518518518518517,0.18518518518518517,0.7407407407407407
8nSQHTsxvlk,4,3,0,7,0.5714285714285714,0.5714285714285714,0.42857142857142855
8ocrD9OttKk,29,57,7,93,0.3118279569892473,0.3118279569892473,0.6129032258064516
8pmriG28ETk,3,11,1,15,0.2,0.2,0.7333333333333333
8ruRrGzOk1I,8,8,3,19,0.42105263157894735,0.42105263157894735,0.42105263157894735
8tOGqVYoNwU,64,57,20,141,0.45390070921985815,0.45390070921985815,0.40425531914893614
8tfFcU9urHA,111,32,6,149,0.7449664429530202,0.7449664429530202,0.21476510067114093
8uj_tJ-7-Bo,32,69,11,112,0.2857142857142857,0.2857142857142857,0.6160714285714286
8vR7wuLYwac,13,19,4,36,0.3611111111111111,0.3611111111111111,0.5277777777777778
8wceyDKKZB8,3,2,0,5,0.6,0.6,0.4
8x-XEfo9rWk,9,9,0,18,0.5,0.5,0.5
8x5y9-bdxmg,88,76,12,176,0.5,0.5,0.4318181818181818
8y6lXLivceE,20,44,1,65,0.3076923076923077,0.3076923076923077,0.676923076923077
8yaAN66zO9I,234,165,27,426,0.5492957746478874,0.5492957746478874,0.3873239436619718
8z5pBNCvmqA,10,38,10,58,0.1724137931034483,0.1724137931034483,0.6551724137931034
8zG2Gwis0vI,18,30,5,53,0.33962264150943394,0.33962264150943394,0.5660377358490566
9-B9rWOe960,5,2,0,7,0.7142857142857143,0.7142857142857143,0.2857142857142857
9-I8G5bcEXc,37,53,6,96,0.3854166666666667,0.3854166666666667,0.5520833333333334
91U319yrc80,17,14,6,37,0.4594594594594595,0.4594594594594595,0.3783783783783784
91v7pZeZqkU,11,2,2,15,0.7333333333333333,0.7333333333333333,0.13333333333333333
94-wK3hwgN0,0,12,0,12,0,0,1
94iSYGbn1cU,2,12,3,17,0.11764705882352941,0.11764705882352941,0.7058823529411765
969lpBmDvD4,9,2,2,13,0.6923076923076923,0.6923076923076923,0.15384615384615385
96pLCDFOCD8,10,12,0,22,0.45454545454545453,0.45454545454545453,0.5454545454545454
97GuC4kuvgU,21,41,4,66,0.3181818181818182,0.3181818181818182,0.6212121212121212
97M3rElx_PM,7,45,4,56,0.125,0.125,0.8035714285714286
97d-jIfzfhE,30,85,10,125,0.24,0.24,0.68
98i9xbg_Lt0,6,12,0,18,0.3333333333333333,0.3333333333333333,0.6666666666666666
99I5y9RIYuk,18,11,1,30,0.6,0.6,0.36666666666666664
99xSa4SbgaU,137,188,14,339,0.40412979351032446,0.40412979351032446,0.5545722713864307
9A8pMxW4G8o,24,84,6,114,0.21052631578947367,0.21052631578947367,0.7368421052631579
9AM4DDjV_Iw,7,3,1,11,0.6363636363636364,0.6363636363636364,0.2727272727272727
9AasPSGO7_w,14,14,1,29,0.4827586206896552,0.4827586206896552,0.4827586206896552
9C7M9-L9wmU,3,8,0,11,0.2727272727272727,0.2727272727272727,0.7272727272727273
9Cz_40tvP14,6,13,1,20,0.3,0.3,0.65
9DaYu1-b0Xo,13,29,2,44,0.29545454545454547,0.29545454545454547,0.6590909090909091
9DpBE6CJxmU,6,6,1,13,0.46153846153846156,0.46153846153846156,0.46153846153846156
9Ek-GqpeII4,39,25,7,71,0.5492957746478874,0.5492957746478874,0.352112676056338
9HWc8TYa1tc,16,33,2,51,0.3137254901960784,0.3137254901960784,0.6470588235294118
9KFbBtKWEXE,66,44,7,117,0.5641025641025641,0.5641025641025641,0.37606837606837606
9MJWeCQLwqQ,1,0,1,2,0.5,0.5,0
9MeZpjwak-o,5,1,0,6,0.8333333333333334,0.8333333333333334,0.16666666666666666
9N5_sa9GXdA,116,118,17,251,0.46215139442231074,0.46215139442231074,0.4701195219123506
9N7R4Xyd68c,39,41,6,86,0.45348837209302323,0.45348837209302323,0.47674418604651164
9OZ_cUiVQpQ,29,52,10,91,0.31868131868131866,0.31868131868131866,0.5714285714285714
9OxKyr9unls,22,30,3,55,0.4,0.4,0.5454545454545454
9PqyowERkBg,0,2,0,2,0,0,1
9Q0rVyY9Gf0,37,136,26,199,0.18592964824120603,0.18592964824120603,0.6834170854271356
9QhQhbwr7mQ,20,85,7,112,0.17857142857142858,0.17857142857142858,0.7589285714285714
9RLrQUd5W_g,176,789,131,1096,0.16058394160583941,0.16058394160583941,0.7198905109489051
9RiaxxfKjgc,7,13,2,22,0.3181818181818182,0.3181818181818182,0.5909090909090909
9S4EScCNrZ8,2,2,0,4,0.5,0.5,0.5
9SntgdnKO10,14,53,2,69,0.2028985507246377,0.2028985507246377,0.7681159420289855
9TubZPgKplM,40,39,9,88,0.45454545454545453,0.45454545454545453,0.4431818181818182
9V9vYSoI_2w,1,7,1,9,0.1111111111111111,0.1111111111111111,0.7777777777777778
9YXZFUDMnLU,0,3,1,4,0,0,0.75
9ZUOt7JoA9c,8,21,2,31,0.25806451612903225,0.25806451612903225,0.6774193548387096
9_JRxfaxy-w,111,158,23,292,0.3801369863013699,0.3801369863013699,0.541095890410959
9_fBgCRl4O0,8,45,11,64,0.125,0.125,0.703125
9_rkuAaoSx0,2,15,0,17,0.11764705882352941,0.11764705882352941,0.8823529411764706
9aGfSQOZDvk,103,38,1,142,0.7253521126760564,0.7253521126760564,0.2676056338028169
9aOBYOGvXIw,11,31,1,43,0.2558139534883721,0.2558139534883721,0.7209302325581395
9avxAGDRS9w,7,22,5,34,0.20588235294117646,0.20588235294117646,0.6470588235294118
9c1NOTgItuQ,17,13,7,37,0.4594594594594595,0.4594594594594595,0.35135135135135137
9dRF8Nxet-w,7,39,11,57,0.12280701754385964,0.12280701754385964,0.6842105263157895
9i0rTCstVj0,107,95,31,233,0.4592274678111588,0.4592274678111588,0.40772532188841204
9ibi_Bx8LbE,6,10,0,16,0.375,0.375,0.625
9l-8oDZRbVw,11,40,9,60,0.18333333333333332,0.18333333333333332,0.6666666666666666
9maP57MC3KM,13,18,0,31,0.41935483870967744,0.41935483870967744,0.5806451612903226
9mnJMdotLO0,6,1,0,7,0.8571428571428571,0.8571428571428571,0.14285714285714285
9n3PfDnyyOE,1,0,0,1,1,1,0
9n80TLeLeOE,13,1,1,15,0.8666666666666667,0.8666666666666667,0.06666666666666667
9qopgQnqu08,30,49,6,85,0.35294117647058826,0.35294117647058826,0.5764705882352941
9r18Q1nKzHw,9,0,0,9,1,1,0
9smE9E0xvY0,4,10,0,14,0.2857142857142857,0.2857142857142857,0.7142857142857143
9tRSImMNjX4,12,53,3,68,0.17647058823529413,0.17647058823529413,0.7794117647058824
9tdfpYXeIjE,6,5,0,11,0.5454545454545454,0.5454545454545454,0.45454545454545453
9ufrki3TlUk,12,30,3,45,0.26666666666666666,0.26666666666666666,0.6666666666666666
9wsHJZAPC2s,7,19,2,28,0.25,0.25,0.6785714285714286
9yGdjgeZ9g8,9,8,0,17,0.5294117647058824,0.5294117647058824,0.47058823529411764
9z9kivMiw2s,253,255,80,588,0.4302721088435374,0.4302721088435374,0.4336734693877551
A0VO4C0vC4w,32,204,12,248,0.12903225806451613,0.12903225806451613,0.8225806451612904
A0YzhsnJ6Mk,5,10,2,17,0.29411764705882354,0.29411764705882354,0.5882352941176471
A10OW358ywQ,14,76,8,98,0.14285714285714285,0.14285714285714285,0.7755102040816326
A2FKwKiQ8r0,6,25,1,32,0.1875,0.1875,0.78125
A2tvCkXUeRM,17,13,0,30,0.5666666666666667,0.5666666666666667,0.43333333333333335
A3LchADFAuA,16,6,1,23,0.6956521739130435,0.6956521739130435,0.2608695652173913
A3Pfext4Rp4,17,23,3,43,0.3953488372093023,0.3953488372093023,0.5348837209302325
A3_MU_aLwok,14,27,3,44,0.3181818181818182,0.3181818181818182,0.6136363636363636
A4E__2yRQfs,7,9,2,18,0.3888888888888889,0.3888888888888889,0.5
A6LUDtvTBg8,77,56,2,135,0.5703703703703704,0.5703703703703704,0.4148148148148148
A8164TLraT4,3,20,2,25,0.12,0.12,0.8
A8Su0OXyioQ,3,14,1,18,0.16666666666666666,0.16666666666666666,0.7777777777777778
A9gDZ2R2v78,21,17,2,40,0.525,0.525,0.425
ABiJT3l63zk,3,1,3,7,0.42857142857142855,0.42857142857142855,0.14285714285714285
ACM4xER8PHE,10,9,3,22,0.45454545454545453,0.45454545454545453,0.4090909090909091
ADEfqhWLRvc,6,5,1,12,0.5,0.5,0.4166666666666667
ADR29ohFsKY,18,10,1,29,0.6206896551724138,0.6206896551724138,0.3448275862068966
AEa9hqsKcrg,2,6,0,8,0.25,0.25,0.75
AG5Jts9R3DM,39,47,11,97,0.4020618556701031,0.4020618556701031,0.4845360824742268
AGDr7hodijk,3,5,1,9,0.3333333333333333,0.3333333333333333,0.5555555555555556
AHPkKVkKQsM,17,52,5,74,0.22972972972972974,0.22972972972972974,0.7027027027027027
AIF5wdT7Q5A,25,32,1,58,0.43103448275862066,0.43103448275862066,0.5517241379310345
AJ4ofgDXRag,6,13,2,21,0.2857142857142857,0.2857142857142857,0.6190476190476191
AJdDLJdoFUk,7,18,8,33,0.21212121212121213,0.21212121212121213,0.5454545454545454
AKYAQLD0pIs,2,19,4,25,0.08,0.08,0.76
AKeeNpoBwd4,11,36,1,48,0.22916666666666666,0.22916666666666666,0.75
ALfmEfq93yI,7,9,5,21,0.3333333333333333,0.3333333333333333,0.42857142857142855
AMecmzQ3x2A,9,8,3,20,0.45,0.45,0.4
AMs9lPD7SVY,9,71,6,86,0.10465116279069768,0.10465116279069768,0.8255813953488372
AN2gWqQgDjY,0,4,1,5,0,0,0.8
ANG3KYZhLTk,49,43,2,94,0.5212765957446809,0.5212765957446809,0.4574468085106383
AOP_q4TCP8g,7,19,0,26,0.2692307692307692,0.2692307692307692,0.7307692307692307
AOeIBGAXyZE,6,6,0,12,0.5,0.5,0.5
APz3RE0Oy20,36,32,3,71,0.5070422535211268,0.5070422535211268,0.4507042253521127
AQ7suHzKkO4,13,23,2,38,0.34210526315789475,0.34210526315789475,0.6052631578947368
AQ_RWhW3840,8,6,0,14,0.5714285714285714,0.5714285714285714,0.42857142857142855
AQx4VWeN-5g,7,23,4,34,0.20588235294117646,0.20588235294117646,0.6764705882352942
ASK15WDOyRU,5,22,1,28,0.17857142857142858,0.17857142857142858,0.7857142857142857
ASNB316dnFc,102,322,63,487,0.20944558521560575,0.20944558521560575,0.6611909650924025
AU2XdLYZuPc,14,11,3,28,0.5,0.5,0.39285714285714285
AUHG9Z6TiNg,10,22,5,37,0.2702702702702703,0.2702702702702703,0.5945945945945946
AUOjyCRgqr4,11,31,3,45,0.24444444444444444,0.24444444444444444,0.6888888888888889
AVA0Lcx-Tzc,4,4,0,8,0.5,0.5,0.5
AVZjIBGcRH0,2,4,0,6,0.3333333333333333,0.3333333333333333,0.6666666666666666
AW9XsOYkv8s,8,10,1,19,0.42105263157894735,0.42105263157894735,0.5263157894736842
AWpTxCfGj7U,39,79,3,121,0.32231404958677684,0.32231404958677684,0.6528925619834711
AXyNzIraa8c,3,15,5,23,0.13043478260869565,0.13043478260869565,0.6521739130434783
AXzE_hJabXA,29,21,3,53,0.5471698113207547,0.5471698113207547,0.39622641509433965
AaHKpD9e3BE,27,79,9,115,0.23478260869565218,0.23478260869565218,0.6869565217391305
AcXuJAyia-I,17,10,4,31,0.5483870967741935,0.5483870967741935,0.3225806451612903
AemhulF32Wo,16,19,4,39,0.41025641025641024,0.41025641025641024,0.48717948717948717
AfYh_8_uK0k,34,49,8,91,0.37362637362637363,0.37362637362637363,0.5384615384615384
AhnjURecFiM,12,29,6,47,0.2553191489361702,0.2553191489361702,0.6170212765957447
Aj20CzOa6CE,27,15,2,44,0.6136363636363636,0.6136363636363636,0.3409090909090909
Aj2TGoJqZJY,7,7,0,14,0.5,0.5,0.5
AkWV62Cf-uQ,123,87,9,219,0.5616438356164384,0.5616438356164384,0.3972602739726027
AlM0bzeUH6o,7,19,1,27,0.25925925925925924,0.25925925925925924,0.7037037037037037
AlWcdQfigps,11,16,1,28,0.39285714285714285,0.39285714285714285,0.5714285714285714
AlhLP-qmCUY,3,9,0,12,0.25,0.25,0.75
AmJpIFXCNkg,7,34,4,45,0.15555555555555556,0.15555555555555556,0.7555555555555555
AmiDPC60qwc,9,31,0,40,0.225,0.225,0.775
An0FnT88AKs,2,13,1,16,0.125,0.125,0.8125
An1G2pN4rmE,19,16,2,37,0.5135135135135135,0.5135135135135135,0.43243243243243246
AoSH7ft18x8,7,13,1,21,0.3333333333333333,0.3333333333333333,0.6190476190476191
Ap6DG_dh0nY,46,185,37,268,0.17164179104477612,0.17164179104477612,0.6902985074626866
Ap6niRDmowU,123,147,8,278,0.44244604316546765,0.44244604316546765,0.5287769784172662
ApCMNq3iSXc,0,2,0,2,0,0,1
ArCssCsazLM,8,4,0,12,0.6666666666666666,0.6666666666666666,0.3333333333333333
ArJp67ZDe9c,6,13,2,21,0.2857142857142857,0.2857142857142857,0.6190476190476191
AsAfJb8_9BE,2,7,1,10,0.2,0.2,0.7
AtbqEe_08Ho,8,5,0,13,0.6153846153846154,0.6153846153846154,0.38461538461538464
Av1QT5tNXsQ,18,18,0,36,0.5,0.5,0.5
AvHM59qMEN0,33,68,9,110,0.3,0.3,0.6181818181818182
Awo6vCOa56k,2,9,1,12,0.16666666666666666,0.16666666666666666,0.75
Az1zkHo4gSY,142,148,11,301,0.4717607973421927,0.4717607973421927,0.49169435215946844
B-SsRbY4wQM,13,17,0,30,0.43333333333333335,0.43333333333333335,0.5666666666666667
B-gxATbnV44,26,32,3,61,0.4262295081967213,0.4262295081967213,0.5245901639344263
B0hduuC-38c,26,23,2,51,0.5098039215686274,0.5098039215686274,0.45098039215686275
B1K4hypR1hk,17,50,7,74,0.22972972972972974,0.22972972972972974,0.6756756756756757
B1Mn6IcTJ6o,45,29,5,79,0.569620253164557,0.569620253164557,0.3670886075949367
B1TaQnAurGA,45,196,5,246,0.18292682926829268,0.18292682926829268,0.7967479674796748
B3wI8rI14UU,4,13,0,17,0.23529411764705882,0.23529411764705882,0.7647058823529411
B5HUOp76lgw,41,130,18,189,0.21693121693121692,0.21693121693121692,0.6878306878306878
B6foMqSV890,7,10,0,17,0.4117647058823529,0.4117647058823529,0.5882352941176471
B790XPjyt8w,4,16,0,20,0.2,0.2,0.8
BBoV6nhATEM,10,7,0,17,0.5882352941176471,0.5882352941176471,0.4117647058823529
BD2Lcz3jwF0,9,27,2,38,0.23684210526315788,0.23684210526315788,0.7105263157894737
BD2wkE6TB2U,19,20,1,40,0.475,0.475,0.5
BDE3_EyQPig,5,17,2,24,0.20833333333333334,0.20833333333333334,0.7083333333333334
BDERzTyKgjs,30,47,3,80,0.375,0.375,0.5875
BDMh2OtxYJE,3,1,0,4,0.75,0.75,0.25
BEupNohz5UE,25,26,10,61,0.4098360655737705,0.4098360655737705,0.4262295081967213
BFupBfyYnik,3,27,0,30,0.1,0.1,0.9
BG08E1-6l4w,2,5,0,7,0.2857142857142857,0.2857142857142857,0.7142857142857143
BGTkgVivdwE,14,22,3,39,0.358974358974359,0.358974358974359,0.5641025641025641
BHaeKo6c0jk,2,7,2,11,0.18181818181818182,0.18181818181818182,0.6363636363636364
BKGme3HQOVM,8,15,1,24,0.3333333333333333,0.3333333333333333,0.625
BKcfSU7-Klo,1,15,1,17,0.058823529411764705,0.058823529411764705,0.8823529411764706
BKwHz9egq1c,0,2,1,3,0,0,0.6666666666666666
BLLW320tmao,13,23,2,38,0.34210526315789475,0.34210526315789475,0.6052631578947368
BLjMnSXqNtE,11,5,1,17,0.6470588235294118,0.6470588235294118,0.29411764705882354
BMfdWSEwsqc,2,6,2,10,0.2,0.2,0.6
BNBt8PKhnEI,8,37,2,47,0.1702127659574468,0.1702127659574468,0.7872340425531915
BPOFYhiW8U0,11,8,2,21,0.5238095238095238,0.5238095238095238,0.38095238095238093
BRZWlmve3uk,0,7,0,7,0,0,1
BSTzxlNJHY8,72,123,32,227,0.31718061674008813,0.31718061674008813,0.5418502202643172
BSpjh4shFPs,6,30,5,41,0.14634146341463414,0.14634146341463414,0.7317073170731707
BTXsD4ZC7Y4,113,58,12,183,0.6174863387978142,0.6174863387978142,0.31693989071038253
BVh6YZvlQRM,23,29,3,55,0.41818181818181815,0.41818181818181815,0.5272727272727272
BXbYFvftRLc,3,23,3,29,0.10344827586206896,0.10344827586206896,0.7931034482758621
BYd5cf5lkg8,40,32,4,76,0.5263157894736842,0.5263157894736842,0.42105263157894735
BZMQI76i2zE,9,4,1,14,0.6428571428571429,0.6428571428571429,0.2857142857142857
BZW2n9GyF9A,3,12,0,15,0.2,0.2,0.8
BZXbtR63fhk,0,1,0,1,0,0,1
B_sXaSYcbqU,19,49,6,74,0.25675675675675674,0.25675675675675674,0.6621621621621622
BaCSzIZJz3E,7,8,0,15,0.4666666666666667,0.4666666666666667,0.5333333333333333
Bb1_eQj1MHQ,24,40,5,69,0.34782608695652173,0.34782608695652173,0.5797101449275363
Bd1Pj9ikMpY,7,17,2,26,0.2692307692307692,0.2692307692307692,0.6538461538461539
Bdg52BkQw58,18,31,3,52,0.34615384615384615,0.34615384615384615,0.5961538461538461
BgHUrM28tGo,12,39,1,52,0.23076923076923078,0.23076923076923078,0.75
BjNDK-obLug,11,21,2,34,0.3235294117647059,0.3235294117647059,0.6176470588235294
Bjzm985wqnU,8,2,0,10,0.8,0.8,0.2
BkN6WhNe4JQ,8,28,2,38,0.21052631578947367,0.21052631578947367,0.7368421052631579
BkWbA0VjLOE,13,37,3,53,0.24528301886792453,0.24528301886792453,0.6981132075471698
BllnEwBdaUY,18,25,0,43,0.4186046511627907,0.4186046511627907,0.5813953488372093
Bo34gYMO2vs,11,11,4,26,0.4230769230769231,0.4230769230769231,0.4230769230769231
Bo4zOQZhD0M,45,159,24,228,0.19736842105263158,0.19736842105263158,0.6973684210526315
BoT2EjZnHS4,4,12,1,17,0.23529411764705882,0.23529411764705882,0.7058823529411765
BoocRcn4tS0,19,15,2,36,0.5277777777777778,0.5277777777777778,0.4166666666666667
Brrsva3d06A,7,18,1,26,0.2692307692307692,0.2692307692307692,0.6923076923076923
Bs6tNu-P-oc,10,36,4,50,0.2,0.2,0.72
Bu_AAMNtBHc,16,15,0,31,0.5161290322580645,0.5161290322580645,0.4838709677419355
Bv9B_wrLoV8,7,39,3,49,0.14285714285714285,0.14285714285714285,0.7959183673469388
Bw2Sn4XB11Y,121,476,40,637,0.18995290423861852,0.18995290423861852,0.7472527472527473
BwD67gZqHVg,7,33,0,40,0.175,0.175,0.825
Bwz4etfLEVM,5,11,1,17,0.29411764705882354,0.29411764705882354,0.6470588235294118
ByGpq66Nymw,3,7,1,11,0.2727272727272727,0.2727272727272727,0.6363636363636364
C-VA6SrNlFQ,7,25,2,34,0.20588235294117646,0.20588235294117646,0.7352941176470589
C-ahukacytA,18,21,5,44,0.4090909090909091,0.4090909090909091,0.4772727272727273
C06VfvB9WvM,15,26,4,45,0.3333333333333333,0.3333333333333333,0.5777777777777777
C13kGdiynTc,35,35,8,78,0.44871794871794873,0.44871794871794873,0.44871794871794873
C1IKlvOJjN8,12,14,3,29,0.41379310344827586,0.41379310344827586,0.4827586206896552
C1bSHDFfNhY,172,92,18,282,0.6099290780141844,0.6099290780141844,0.3262411347517731
C1pq0QeTlaU,4,4,3,11,0.36363636363636365,0.36363636363636365,0.36363636363636365
C2fY7RbuVCg,34,48,8,90,0.37777777777777777,0.37777777777777777,0.5333333333333333
C5gG9wkY2EE,10,8,0,18,0.5555555555555556,0.5555555555555556,0.4444444444444444
C6wu_yUUUDg,7,8,0,15,0.4666666666666667,0.4666666666666667,0.5333333333333333
C917-eugBBU,15,68,5,88,0.17045454545454544,0.17045454545454544,0.7727272727272727
C9NzAfC9jKk,1,7,6,14,0.07142857142857142,0.07142857142857142,0.5
CDNjstN27sw,65,102,16,183,0.3551912568306011,0.3551912568306011,0.5573770491803278
CFC9QqqvHjQ,1,32,3,36,0.027777777777777776,0.027777777777777776,0.8888888888888888
CGjSp9kr3TE,44,60,5,109,0.4036697247706422,0.4036697247706422,0.5504587155963303
CHhnAO0Y9ZU,14,31,1,46,0.30434782608695654,0.30434782608695654,0.6739130434782609
CHzPJRuGitU,8,2,2,12,0.6666666666666666,0.6666666666666666,0.16666666666666666
CJdnaEiB1l4,6,16,2,24,0.25,0.25,0.6666666666666666
CKzKjYgjorg,6,9,0,15,0.4,0.4,0.6
CLqZvZc7TPw,2,8,1,11,0.18181818181818182,0.18181818181818182,0.7272727272727273
CMRIEnmeqzw,82,79,6,167,0.49101796407185627,0.49101796407185627,0.47305389221556887
CMUCpFw4YHI,5,3,0,8,0.625,0.625,0.375
COKvpMMEeTE,15,57,1,73,0.2054794520547945,0.2054794520547945,0.7808219178082192
COmLywMKVJM,8,13,1,22,0.36363636363636365,0.36363636363636365,0.5909090909090909
CRp5hzmtTyM,4,16,1,21,0.19047619047619047,0.19047619047619047,0.7619047619047619
CS-Vpo35ewQ,14,56,1,71,0.19718309859154928,0.19718309859154928,0.7887323943661971
CSMjmYirWDs,5,10,0,15,0.3333333333333333,0.3333333333333333,0.6666666666666666
CTUZm0lQIz0,5,17,1,23,0.21739130434782608,0.21739130434782608,0.7391304347826086
CU1LInrUolE,6,23,2,31,0.1935483870967742,0.1935483870967742,0.7419354838709677
CX8JGV6U84Q,27,81,8,116,0.23275862068965517,0.23275862068965517,0.6982758620689655
CYNHYN2blQY,53,34,15,102,0.5196078431372549,0.5196078431372549,0.3333333333333333
CZXicSv53zE,43,23,4,70,0.6142857142857143,0.6142857142857143,0.32857142857142857
C_hAw6jIhms,14,30,4,48,0.2916666666666667,0.2916666666666667,0.625
Ca8Fz8Nke3w,8,3,0,11,0.7272727272727273,0.7272727272727273,0.2727272727272727
Cajh6HS6NYM,4,6,2,12,0.3333333333333333,0.3333333333333333,0.5
CaxVDxdxKIg,207,319,85,611,0.33878887070376434,0.33878887070376434,0.5220949263502455
CbfEJvJpWOw,75,26,1,102,0.7352941176470589,0.7352941176470589,0.2549019607843137
Cbpjmq8vrYk,6,2,0,8,0.75,0.75,0.25
CcsjKN-ZPwM,145,9,9,163,0.8895705521472392,0.8895705521472392,0.05521472392638037
CdJDa0muF1A,8,23,3,34,0.23529411764705882,0.23529411764705882,0.6764705882352942
CdVIinPz_To,75,70,8,153,0.49019607843137253,0.49019607843137253,0.45751633986928103
Cek0Vf77fbQ,14,13,2,29,0.4827586206896552,0.4827586206896552,0.4482758620689655
CgPETt7TuyI,1,3,0,4,0.25,0.25,0.75
CgcuqLwavDE,2,1,0,3,0.6666666666666666,0.6666666666666666,0.3333333333333333
ChDueM_JUwI,83,62,7,152,0.5460526315789473,0.5460526315789473,0.40789473684210525
ChQknkyaGBw,11,8,0,19,0.5789473684210527,0.5789473684210527,0.42105263157894735
ChopNRQ7VVg,3,16,1,20,0.15,0.15,0.8
CnUnBkiJbvg,9,10,0,19,0.47368421052631576,0.47368421052631576,0.5263157894736842
CnlsbRogZ5E,35,30,4,69,0.5072463768115942,0.5072463768115942,0.43478260869565216
CofSsn4n2GE,25,63,12,100,0.25,0.25,0.63
CpO-cNrPSgc,37,24,6,67,0.5522388059701493,0.5522388059701493,0.3582089552238806
Cpgm7WCmz0w,35,79,11,125,0.28,0.28,0.632
CqOXWtBq9iI,18,22,3,43,0.4186046511627907,0.4186046511627907,0.5116279069767442
CqrplD953KM,8,44,4,56,0.14285714285714285,0.14285714285714285,0.7857142857142857
CrCIF1pZcZA,36,17,2,55,0.6545454545454545,0.6545454545454545,0.3090909090909091
CsYVO2bQYq8,71,122,10,203,0.3497536945812808,0.3497536945812808,0.6009852216748769
Ct19dddhIAQ,7,13,1,21,0.3333333333333333,0.3333333333333333,0.6190476190476191
CuXDXXT-ecc,5,6,0,11,0.45454545454545453,0.45454545454545453,0.5454545454545454
CvJp0JZZIyg,10,6,0,16,0.625,0.625,0.375
CvaJnxbLZNE,3,4,0,7,0.42857142857142855,0.42857142857142855,0.5714285714285714
CvhLnUvlYZo,22,32,5,59,0.3728813559322034,0.3728813559322034,0.5423728813559322
Cw3PvhJ6pm8,8,16,1,25,0.32,0.32,0.64
CwRBed0VlZ0,3,9,0,12,0.25,0.25,0.75
CxPt7TJMQCs,9,5,3,17,0.5294117647058824,0.5294117647058824,0.29411764705882354
Cx_7_8M56cY,4,74,3,81,0.04938271604938271,0.04938271604938271,0.9135802469135802
CxqxgYzpGYM,54,115,14,183,0.29508196721311475,0.29508196721311475,0.6284153005464481
CyT97FfAZos,13,13,0,26,0.5,0.5,0.5
CyUeBiw-MWA,28,14,2,44,0.6363636363636364,0.6363636363636364,0.3181818181818182
Czlq3e07PTg,19,31,0,50,0.38,0.38,0.62
CzlrguKndh8,28,40,6,74,0.3783783783783784,0.3783783783783784,0.5405405405405406
D-FToxnL-VE,51,124,10,185,0.2756756756756757,0.2756756756756757,0.6702702702702703
D-ldiABO-pA,13,5,1,19,0.6842105263157895,0.6842105263157895,0.2631578947368421
D16-xraLry0,6,4,1,11,0.5454545454545454,0.5454545454545454,0.36363636363636365
D2zDFsWwaSY,7,32,2,41,0.17073170731707318,0.17073170731707318,0.7804878048780488
D3onwzP1vug,12,12,1,25,0.48,0.48,0.48
D591Vc9lp24,28,50,10,88,0.3181818181818182,0.3181818181818182,0.5681818181818182
D6OmCjKB3oE,28,14,9,51,0.5490196078431373,0.5490196078431373,0.27450980392156865
D7SBDCtH1nQ,16,11,2,29,0.5517241379310345,0.5517241379310345,0.3793103448275862
D7UQE4K13D4,19,15,2,36,0.5277777777777778,0.5277777777777778,0.4166666666666667
D8POKbQd76Y,14,5,0,19,0.7368421052631579,0.7368421052631579,0.2631578947368421
D9DG7TrMZHc,46,36,6,88,0.5227272727272727,0.5227272727272727,0.4090909090909091
D9LyERBHvYk,14,13,0,27,0.5185185185185185,0.5185185185185185,0.48148148148148145
D9zjRVypIio,17,19,4,40,0.425,0.425,0.475
DAos5CqONvA,4,32,5,41,0.0975609756097561,0.0975609756097561,0.7804878048780488
DBJqhCPiZE4,617,2289,459,3365,0.18335809806835066,0.18335809806835066,0.6802377414561664
DC1ZAvXT_VU,182,70,22,274,0.6642335766423357,0.6642335766423357,0.25547445255474455
DCUEsstCgVw,6,13,3,22,0.2727272727272727,0.2727272727272727,0.5909090909090909
DCh-mmQn26E,44,146,10,200,0.22,0.22,0.73
DDns07agUX4,6,40,6,52,0.11538461538461539,0.11538461538461539,0.7692307692307693
DEufQPtrP0Y,9,14,0,23,0.391304347826087,0.391304347826087,0.6086956521739131
DGhRQdsDOI4,4,12,0,16,0.25,0.25,0.75
DHC4QoBGYHs,3,1,0,4,0.75,0.75,0.25
DIpYGItg60k,1,0,0,1,1,1,0
DItEvY92g_I,66,262,45,373,0.1769436997319035,0.1769436997319035,0.7024128686327078
DJKX4-Heh8Q,11,15,0,26,0.4230769230769231,0.4230769230769231,0.5769230769230769
DMDMp5O-4J4,15,19,9,43,0.3488372093023256,0.3488372093023256,0.4418604651162791
DMyJK36Qomk,176,140,20,336,0.5238095238095238,0.5238095238095238,0.4166666666666667
DN-59ohIW4s,1,3,0,4,0.25,0.25,0.75
DNS-grVdBGY,5,2,0,7,0.7142857142857143,0.7142857142857143,0.2857142857142857
DNdkNu8jUp0,8,12,2,22,0.36363636363636365,0.36363636363636365,0.5454545454545454
DQ9RennF3PU,19,37,8,64,0.296875,0.296875,0.578125
DQORwGXevtg,148,79,15,242,0.6115702479338843,0.6115702479338843,0.32644628099173556
DRPkZkfhCkQ,163,40,18,221,0.7375565610859729,0.7375565610859729,0.18099547511312217
DTMjoMYlghs,16,34,12,62,0.25806451612903225,0.25806451612903225,0.5483870967741935
DUKwAQOC8n4,35,188,10,233,0.15021459227467812,0.15021459227467812,0.8068669527896996
DU_LkOV2FWE,4,52,2,58,0.06896551724137931,0.06896551724137931,0.896551724137931
DVF5nTn5DQU,23,98,17,138,0.16666666666666666,0.16666666666666666,0.7101449275362319
DWXS57s2Fjk,12,6,2,20,0.6,0.6,0.3
DXyxaichhPA,9,26,7,42,0.21428571428571427,0.21428571428571427,0.6190476190476191
DYkz6JNNNXk,11,23,2,36,0.3055555555555556,0.3055555555555556,0.6388888888888888
DZQjaB9jTEg,12,11,2,25,0.48,0.48,0.44
D_M48ujns7s,34,52,6,92,0.3695652173913043,0.3695652173913043,0.5652173913043478
D_i-NtlWCGU,10,20,2,32,0.3125,0.3125,0.625
DaVyYtdYEtM,12,6,0,18,0.6666666666666666,0.6666666666666666,0.3333333333333333
DarjFmBtutc,0,1,0,1,0,0,1
DboJkTC6ZdU,8,15,2,25,0.32,0.32,0.6
DciTdMTjihA,2,23,3,28,0.07142857142857142,0.07142857142857142,0.8214285714285714
DdQl3FzA0TI,3,15,1,19,0.15789473684210525,0.15789473684210525,0.7894736842105263
DdyUBmEDe44,13,25,4,42,0.30952380952380953,0.30952380952380953,0.5952380952380952
DeJvAjaTotw,16,113,2,131,0.12213740458015267,0.12213740458015267,0.8625954198473282
DfcQ2CJYODg,38,16,4,58,0.6551724137931034,0.6551724137931034,0.27586206896551724
Dg-DUMT14ow,5,19,0,24,0.20833333333333334,0.20833333333333334,0.7916666666666666
DhLw3xDsMYc,5,12,1,18,0.2777777777777778,0.2777777777777778,0.6666666666666666
Di-hts_gVKg,22,28,7,57,0.38596491228070173,0.38596491228070173,0.49122807017543857
Di6R30lEt_4,28,28,1,57,0.49122807017543857,0.49122807017543857,0.49122807017543857
DilQ8oLP1Rs,7,17,1,25,0.28,0.28,0.68
DjNDAxxelI8,20,80,6,106,0.18867924528301888,0.18867924528301888,0.7547169811320755
DkPp6juuB_I,13,11,4,28,0.4642857142857143,0.4642857142857143,0.39285714285714285
DkRSVtGVQdM,140,617,91,848,0.1650943396226415,0.1650943396226415,0.7275943396226415
DkZO9ilUX94,3,15,7,25,0.12,0.12,0.6
Dl5ybeX04PI,36,24,2,62,0.5806451612903226,0.5806451612903226,0.3870967741935484
Dm9m9nD0xGA,30,16,1,47,0.6382978723404256,0.6382978723404256,0.3404255319148936
DnVnwU2lJfc,18,7,0,25,0.72,0.72,0.28
Dnm8gnoTCf0,10,27,0,37,0.2702702702702703,0.2702702702702703,0.7297297297297297
DofXhznOMIk,31,24,9,64,0.484375,0.484375,0.375
DoriUwXrbT4,35,151,8,194,0.18041237113402062,0.18041237113402062,0.7783505154639175
DqKglBY3Jr8,12,28,1,41,0.2926829268292683,0.2926829268292683,0.6829268292682927
DvAyziUwcb8,3,3,0,6,0.5,0.5,0.5
DvmSetYD5Ts,27,163,18,208,0.12980769230769232,0.12980769230769232,0.7836538461538461
Dvq1OHZdyA4,22,7,1,30,0.7333333333333333,0.7333333333333333,0.23333333333333334
DwIV45G67zU,7,5,1,13,0.5384615384615384,0.5384615384615384,0.38461538461538464
DwjWW2JV7H0,7,30,2,39,0.1794871794871795,0.1794871794871795,0.7692307692307693
Dx7AS9gjKSw,2,3,0,5,0.4,0.4,0.6
DxkdiL6a3G8,8,4,1,13,0.6153846153846154,0.6153846153846154,0.3076923076923077
Dz0bhd0KR9o,2,6,2,10,0.2,0.2,0.6
Dzi9EcBWNe0,9,34,6,49,0.1836734693877551,0.1836734693877551,0.6938775510204082
E-hBz5f9fWA,37,49,5,91,0.4065934065934066,0.4065934065934066,0.5384615384615384
E-koliGRPDI,22,6,9,37,0.5945945945945946,0.5945945945945946,0.16216216216216217
E004oVKf5yg,8,11,0,19,0.42105263157894735,0.42105263157894735,0.5789473684210527
E0GpXMoD_m0,11,5,2,18,0.6111111111111112,0.6111111111111112,0.2777777777777778
E0R4T22NIWU,2,27,0,29,0.06896551724137931,0.06896551724137931,0.9310344827586207
E108xMzIvhY,45,15,9,69,0.6521739130434783,0.6521739130434783,0.21739130434782608
E2EcgUPNerg,5,21,1,27,0.18518518518518517,0.18518518518518517,0.7777777777777778
E2RVzkhGJTs,11,12,2,25,0.44,0.44,0.48
E4G_NtP-OyA,125,205,23,353,0.35410764872521244,0.35410764872521244,0.5807365439093485
E5hTlUrBhiY,8,22,0,30,0.26666666666666666,0.26666666666666666,0.7333333333333333
E6eVZmj7QoI,12,33,0,45,0.26666666666666666,0.26666666666666666,0.7333333333333333
E7QFj1aV3qQ,18,26,5,49,0.3673469387755102,0.3673469387755102,0.5306122448979592
E8EzQGoGdug,130,279,66,475,0.2736842105263158,0.2736842105263158,0.5873684210526315
E8TZIHdO54A,9,12,1,22,0.4090909090909091,0.4090909090909091,0.5454545454545454
EATTSrM5vB8,188,133,16,337,0.5578635014836796,0.5578635014836796,0.39465875370919884
EAffZGEICW0,16,13,1,30,0.5333333333333333,0.5333333333333333,0.43333333333333335
EAjVJatyCnk,3,6,0,9,0.3333333333333333,0.3333333333333333,0.6666666666666666
EBWs_CWh2e8,3,4,1,8,0.375,0.375,0.5
EBoRt0cSEfY,20,95,8,123,0.16260162601626016,0.16260162601626016,0.7723577235772358
EC6dqKdH_VQ,28,101,9,138,0.2028985507246377,0.2028985507246377,0.7318840579710145
EClLpRObrJA,3,17,1,21,0.14285714285714285,0.14285714285714285,0.8095238095238095
EDTg_Ud-pRo,16,6,1,23,0.6956521739130435,0.6956521739130435,0.2608695652173913
EDxqZIei_MI,11,23,1,35,0.3142857142857143,0.3142857142857143,0.6571428571428571
EE9Jzq7lTzE,10,12,2,24,0.4166666666666667,0.4166666666666667,0.5
EEMMpIjd9WU,19,35,6,60,0.31666666666666665,0.31666666666666665,0.5833333333333334
EFDfDw2s1OU,16,16,6,38,0.42105263157894735,0.42105263157894735,0.42105263157894735
EFxBhYHYb8g,5,4,0,9,0.5555555555555556,0.5555555555555556,0.4444444444444444
EG_5_b2Acs4,5,28,4,37,0.13513513513513514,0.13513513513513514,0.7567567567567568
EIQG8elAbCk,260,128,11,399,0.6516290726817042,0.6516290726817042,0.3208020050125313
EIgCvA0IJk4,1,10,0,11,0.09090909090909091,0.09090909090909091,0.9090909090909091
EIk9V_cp_rw,126,42,20,188,0.6702127659574468,0.6702127659574468,0.22340425531914893
EJHZVGw-Sp8,1,0,1,2,0.5,0.5,0
EJ_HEXq_wsE,39,57,2,98,0.3979591836734694,0.3979591836734694,0.5816326530612245
EKEo66BjuoU,19,28,5,52,0.36538461538461536,0.36538461538461536,0.5384615384615384
EKqt610P1VI,34,43,5,82,0.4146341463414634,0.4146341463414634,0.524390243902439
EL0Ez5TIERs,7,19,3,29,0.2413793103448276,0.2413793103448276,0.6551724137931034
ELa9DAJzQqo,136,206,9,351,0.38746438746438744,0.38746438746438744,0.5868945868945868
ELnW4St0MVg,6,36,2,44,0.13636363636363635,0.13636363636363635,0.8181818181818182
ENYkBaEoeXs,16,41,1,58,0.27586206896551724,0.27586206896551724,0.7068965517241379
EOsYeO_xShc,4,14,2,20,0.2,0.2,0.7
EQGQXpAT7Hs,1,16,4,21,0.047619047619047616,0.047619047619047616,0.7619047619047619
EQIgBoHvX2w,7,12,2,21,0.3333333333333333,0.3333333333333333,0.5714285714285714
ET1CAu8z4t0,1,11,0,12,0.08333333333333333,0.08333333333333333,0.9166666666666666
EVJqgO0SxQk,3,19,3,25,0.12,0.12,0.76
EVpNWAo-hV8,4,3,0,7,0.5714285714285714,0.5714285714285714,0.42857142857142855
EX3-u8wo_Gs,4,2,1,7,0.5714285714285714,0.5714285714285714,0.2857142857142857
EXF4ktUjhcc,41,42,2,85,0.4823529411764706,0.4823529411764706,0.49411764705882355
EYLPiAw805s,48,45,7,100,0.48,0.48,0.45
EZ0iS8PxpuM,11,25,1,37,0.2972972972972973,0.2972972972972973,0.6756756756756757
EZ4gckhy1Q0,14,6,2,22,0.6363636363636364,0.6363636363636364,0.2727272727272727
E_Frf2dz7kM,2,9,1,12,0.16666666666666666,0.16666666666666666,0.75
EaQ9n7yr1xI,13,64,6,83,0.1566265060240964,0.1566265060240964,0.7710843373493976
EaUX9L4Pb_w,15,46,2,63,0.23809523809523808,0.23809523809523808,0.7301587301587301
Edl7J4c-byc,14,53,9,76,0.18421052631578946,0.18421052631578946,0.6973684210526315
EdzA4CHNzT0,21,31,3,55,0.38181818181818183,0.38181818181818183,0.5636363636363636
EdzG3MoctZM,19,17,4,40,0.475,0.475,0.425
Ee6j-i64r88,8,20,0,28,0.2857142857142857,0.2857142857142857,0.7142857142857143
Eece8lzvNoM,18,28,0,46,0.391304347826087,0.391304347826087,0.6086956521739131
EfdVBxPA3_I,6,17,3,26,0.23076923076923078,0.23076923076923078,0.6538461538461539
Ehi1H9HzqLQ,14,34,2,50,0.28,0.28,0.68
Ejgrzw49pJc,2,4,2,8,0.25,0.25,0.5
Ek00YCJq9eI,2,15,1,18,0.1111111111111111,0.1111111111111111,0.8333333333333334
EkCsKUPVGKY,11,13,2,26,0.4230769230769231,0.4230769230769231,0.5
EkoKn4c7lhE,4,44,2,50,0.08,0.08,0.88
Em6QW-BZCZg,74,394,48,516,0.1434108527131783,0.1434108527131783,0.7635658914728682
EmRkdGtXZX4,29,55,9,93,0.3118279569892473,0.3118279569892473,0.5913978494623656
Emhr7ZewZ6s,4,9,0,13,0.3076923076923077,0.3076923076923077,0.6923076923076923
Eq4hLAdv0UY,6,8,0,14,0.42857142857142855,0.42857142857142855,0.5714285714285714
EqMEugXfgHQ,5,37,1,43,0.11627906976744186,0.11627906976744186,0.8604651162790697
ErEVXMbWHis,16,39,10,65,0.24615384615384617,0.24615384615384617,0.6
ErU9VHfQTaE,7,7,5,19,0.3684210526315789,0.3684210526315789,0.3684210526315789
Es6eRpBp59A,34,37,4,75,0.4533333333333333,0.4533333333333333,0.49333333333333335
EsfnGBO8YtI,16,54,4,74,0.21621621621621623,0.21621621621621623,0.7297297297297297
Et6wOFOjWgA,11,25,4,40,0.275,0.275,0.625
EtFfim8bOIA,6,21,1,28,0.21428571428571427,0.21428571428571427,0.75
Eumnjz40KA8,15,29,2,46,0.32608695652173914,0.32608695652173914,0.6304347826086957
EvUdXXzGbDw,100,201,16,317,0.31545741324921134,0.31545741324921134,0.6340694006309149
Evk-vnJxmdQ,6,20,0,26,0.23076923076923078,0.23076923076923078,0.7692307692307693
EwNitrG50EA,3,25,9,37,0.08108108108108109,0.08108108108108109,0.6756756756756757
EwYrxEmTyuA,18,19,3,40,0.45,0.45,0.475
Ex9lG4E13CY,7,21,2,30,0.23333333333333334,0.23333333333333334,0.7
ExMHfloWD7s,27,32,6,65,0.4153846153846154,0.4153846153846154,0.49230769230769234
ExjM5Gy19ew,8,27,3,38,0.21052631578947367,0.21052631578947367,0.7105263157894737
EyRXGchQBuQ,2,13,1,16,0.125,0.125,0.8125
EzBTwiLR4tU,17,22,0,39,0.4358974358974359,0.4358974358974359,0.5641025641025641
F-fg0n19JCE,22,35,1,58,0.3793103448275862,0.3793103448275862,0.603448275862069
F-uBG6MnL80,13,6,0,19,0.6842105263157895,0.6842105263157895,0.3157894736842105
F0ggDl2AOII,89,23,5,117,0.7606837606837606,0.7606837606837606,0.19658119658119658
F2IL2YZmgOo,11,30,1,42,0.2619047619047619,0.2619047619047619,0.7142857142857143
F2QhqTdresc,9,19,4,32,0.28125,0.28125,0.59375
F2V7ZMVTI4I,20,62,9,91,0.21978021978021978,0.21978021978021978,0.6813186813186813
F5OUeEI-tXo,9,17,1,27,0.3333333333333333,0.3333333333333333,0.6296296296296297
F5RfCbRDj3M,17,48,7,72,0.2361111111111111,0.2361111111111111,0.6666666666666666
F7ES69Yrwqs,10,16,0,26,0.38461538461538464,0.38461538461538464,0.6153846153846154
F9bRaMiqK-A,24,48,2,74,0.32432432432432434,0.32432432432432434,0.6486486486486487
FA0aUJPhZ8U,9,11,2,22,0.4090909090909091,0.4090909090909091,0.5
FAjhQkepggk,19,11,1,31,0.6129032258064516,0.6129032258064516,0.3548387096774194
FC5Jvo85QJg,17,13,1,31,0.5483870967741935,0.5483870967741935,0.41935483870967744
FCkMs3rmaL4,4,21,2,27,0.14814814814814814,0.14814814814814814,0.7777777777777778
FDK3_NeCseE,28,45,8,81,0.345679012345679,0.345679012345679,0.5555555555555556
FDO5SXiQFyk,4,36,4,44,0.09090909090909091,0.09090909090909091,0.8181818181818182
FE6ni-_RgNM,8,40,1,49,0.16326530612244897,0.16326530612244897,0.8163265306122449
FEhWJi2CWWU,21,44,5,70,0.3,0.3,0.6285714285714286
FEoNOzaBLoE,41,120,18,179,0.22905027932960895,0.22905027932960895,0.6703910614525139
FF-ADE2_nrk,7,31,9,47,0.14893617021276595,0.14893617021276595,0.6595744680851063
FFx3LVRHkmM,29,12,2,43,0.6744186046511628,0.6744186046511628,0.27906976744186046
FFyf9sTeQaU,12,15,3,30,0.4,0.4,0.5
FGyhVuG5R_U,28,151,7,186,0.15053763440860216,0.15053763440860216,0.8118279569892473
FHkIe5Xbkbg,2,7,4,13,0.15384615384615385,0.15384615384615385,0.5384615384615384
FIKdP5xtKt4,89,70,11,170,0.5235294117647059,0.5235294117647059,0.4117647058823529
FJ-01JK2jrY,1,0,0,1,1,1,0
FJayin2B1Lg,54,249,16,319,0.16927899686520376,0.16927899686520376,0.780564263322884
FMw0Wwky_7s,5,51,1,57,0.08771929824561403,0.08771929824561403,0.8947368421052632
FPHyS1ks5Ds,77,60,8,145,0.5310344827586206,0.5310344827586206,0.41379310344827586
FPfx75g0XkI,21,31,3,55,0.38181818181818183,0.38181818181818183,0.5636363636363636
FQcVSFyegQc,27,77,8,112,0.24107142857142858,0.24107142857142858,0.6875
FRUi0-k9Qro,4,11,0,15,0.26666666666666666,0.26666666666666666,0.7333333333333333
FSwQdU5_c6U,4,7,0,11,0.36363636363636365,0.36363636363636365,0.6363636363636364
FTA01VGfV2A,1,10,0,11,0.09090909090909091,0.09090909090909091,0.9090909090909091
FUulDc8T_6Y,14,26,1,41,0.34146341463414637,0.34146341463414637,0.6341463414634146
FV7VKzCW1C4,8,4,0,12,0.6666666666666666,0.6666666666666666,0.3333333333333333
FV9ONvk2OiA,90,208,17,315,0.2857142857142857,0.2857142857142857,0.6603174603174603
FVCOoScb1Cw,21,50,7,78,0.2692307692307692,0.2692307692307692,0.6410256410256411
FVNtH3S5R0A,1,12,0,13,0.07692307692307693,0.07692307692307693,0.9230769230769231
FW2vX-nWD_4,8,32,6,46,0.17391304347826086,0.17391304347826086,0.6956521739130435
FZUzCWa7lgM,2,2,1,5,0.4,0.4,0.4
FZjtdVeiy-I,12,14,1,27,0.4444444444444444,0.4444444444444444,0.5185185185185185
F_M08nObhG0,15,97,6,118,0.1271186440677966,0.1271186440677966,0.8220338983050848
Fbe7rUL2f6w,7,10,3,20,0.35,0.35,0.5
Fd9HMnGFS-k,7,13,1,21,0.3333333333333333,0.3333333333333333,0.6190476190476191
FdQ4Qpdfstw,19,84,9,112,0.16964285714285715,0.16964285714285715,0.75
FeDsRwbggXQ,3,24,0,27,0.1111111111111111,0.1111111111111111,0.8888888888888888
FeVMdPbn7-8,0,3,0,3,0,0,1
Ff9nDhNQUbI,17,23,2,42,0.40476190476190477,0.40476190476190477,0.5476190476190477
FfpK7ENjAnU,42,133,16,191,0.2198952879581152,0.2198952879581152,0.6963350785340314
FhXlYvDfu8w,73,283,47,403,0.18114143920595532,0.18114143920595532,0.7022332506203474
FjaONzwJ-mU,19,33,9,61,0.3114754098360656,0.3114754098360656,0.5409836065573771
FlfiVZAxecg,18,33,4,55,0.32727272727272727,0.32727272727272727,0.6
FmfvsRrPD00,53,66,7,126,0.42063492063492064,0.42063492063492064,0.5238095238095238
FnHr7u0AZ3c,23,44,5,72,0.3194444444444444,0.3194444444444444,0.6111111111111112
Fnxg3c5uNx8,6,10,2,18,0.3333333333333333,0.3333333333333333,0.5555555555555556
Fo-RSbd8rsw,6,11,1,18,0.3333333333333333,0.3333333333333333,0.6111111111111112
Fo_JpA5WN8s,13,22,5,40,0.325,0.325,0.55
Fp62V7Em_Gw,22,93,5,120,0.18333333333333332,0.18333333333333332,0.775
FprZxpSjEwM,35,24,2,61,0.5737704918032787,0.5737704918032787,0.39344262295081966
Fq7w_ujGlcA,26,32,10,68,0.38235294117647056,0.38235294117647056,0.47058823529411764
FqcT3MrEOa8,11,17,3,31,0.3548387096774194,0.3548387096774194,0.5483870967741935
FrJrH7Oem3o,19,9,0,28,0.6785714285714286,0.6785714285714286,0.32142857142857145
Frf6qTI5n7w,532,1680,81,2293,0.23201046663759267,0.23201046663759267,0.7326646314871348
Fti_-IpLGnA,16,14,2,32,0.5,0.5,0.4375
Fu1Tlf4x2VA,5,13,5,23,0.21739130434782608,0.21739130434782608,0.5652173913043478
Fu7HUIT0YX4,168,136,11,315,0.5333333333333333,0.5333333333333333,0.43174603174603177
Fxa9Up1nyJ8,19,12,3,34,0.5588235294117647,0.5588235294117647,0.35294117647058826
Fxurc9hVBaA,6,24,3,33,0.18181818181818182,0.18181818181818182,0.7272727272727273
Fy_2mZZJOS0,3,8,0,11,0.2727272727272727,0.2727272727272727,0.7272727272727273
FyydmKpkG68,18,8,0,26,0.6923076923076923,0.6923076923076923,0.3076923076923077
G-D7NBaXajs,13,12,1,26,0.5,0.5,0.46153846153846156
G-WisKmiVHw,144,81,9,234,0.6153846153846154,0.6153846153846154,0.34615384615384615
G0b2bMs5Zds,15,64,2,81,0.18518518518518517,0.18518518518518517,0.7901234567901234
G2IIL6-KAbI,17,17,1,35,0.4857142857142857,0.4857142857142857,0.4857142857142857
G3D4eZoR1Lw,11,2,2,15,0.7333333333333333,0.7333333333333333,0.13333333333333333
G3t2CvOgj2A,9,3,3,15,0.6,0.6,0.2
G6UkTC_7y1o,1,0,0,1,1,1,0
G6VsTAXfZBk,7,16,3,26,0.2692307692307692,0.2692307692307692,0.6153846153846154
G71b8a-dmS8,60,89,10,159,0.37735849056603776,0.37735849056603776,0.559748427672956
G7Izh_Zrpn0,881,603,146,1630,0.5404907975460123,0.5404907975460123,0.36993865030674844
G8OsvnDbvW0,9,12,2,23,0.391304347826087,0.391304347826087,0.5217391304347826
G8byB3ONoOU,9,3,0,12,0.75,0.75,0.25
GAnaoKWZk3k,5,2,3,10,0.5,0.5,0.2
GClUyVPvVyg,0,3,1,4,0,0,0.75
GDQpXgNlBCU,3,8,0,11,0.2727272727272727,0.2727272727272727,0.7272727272727273
GEgsIgdhwd4,10,16,4,30,0.3333333333333333,0.3333333333333333,0.5333333333333333
GF-y6jiAD3I,37,209,9,255,0.1450980392156863,0.1450980392156863,0.8196078431372549
GF1JS9VOV_Y,6,3,0,9,0.6666666666666666,0.6666666666666666,0.3333333333333333
GFINnLCETrM,10,35,2,47,0.2127659574468085,0.2127659574468085,0.7446808510638298
GFkw4mM7hZo,16,7,3,26,0.6153846153846154,0.6153846153846154,0.2692307692307692
GFuTvZnb_EI,9,12,0,21,0.42857142857142855,0.42857142857142855,0.5714285714285714
GGJ238CxR-I,24,81,7,112,0.21428571428571427,0.21428571428571427,0.7232142857142857
GI81x4wj_5M,7,24,4,35,0.2,0.2,0.6857142857142857
GILXvSmBwwA,6,12,2,20,0.3,0.3,0.6
GJ6A_nCfUEk,28,40,5,73,0.3835616438356164,0.3835616438356164,0.547945205479452
GJVFb4KHr14,7,25,1,33,0.21212121212121213,0.21212121212121213,0.7575757575757576
GJmBYUF-Ngg,9,22,4,35,0.2571428571428571,0.2571428571428571,0.6285714285714286
GKJWSveqkZM,7,12,1,20,0.35,0.35,0.6
GKOPUxzby9A,4,21,2,27,0.14814814814814814,0.14814814814814814,0.7777777777777778
GLNc0CFIC6o,399,42,9,450,0.8866666666666667,0.8866666666666667,0.09333333333333334
GM1yQApaOCs,14,7,2,23,0.6086956521739131,0.6086956521739131,0.30434782608695654
GMcqs5luIvs,210,253,33,496,0.42338709677419356,0.42338709677419356,0.5100806451612904
GNDuHYTjwUM,42,41,4,87,0.4827586206896552,0.4827586206896552,0.47126436781609193
GOhtIO7-C2s,446,353,48,847,0.526564344746163,0.526564344746163,0.4167650531286895
GP0m7YShJcw,87,170,9,266,0.32706766917293234,0.32706766917293234,0.6390977443609023
GPbsAJrNbrk,14,51,3,68,0.20588235294117646,0.20588235294117646,0.75
GPqq8Py6vRQ,5,21,1,27,0.18518518518518517,0.18518518518518517,0.7777777777777778
GSZ25SDX8gg,23,19,3,45,0.5111111111111111,0.5111111111111111,0.4222222222222222
GSb4_X5HmTI,3,16,2,21,0.14285714285714285,0.14285714285714285,0.7619047619047619
GUMBthyWsdw,5,6,0,11,0.45454545454545453,0.45454545454545453,0.5454545454545454
GUfVYMGvZ0c,16,20,0,36,0.4444444444444444,0.4444444444444444,0.5555555555555556
GVE3jXc9rVc,5,14,6,25,0.2,0.2,0.56
GVddtTjmtHQ,16,33,3,52,0.3076923076923077,0.3076923076923077,0.6346153846153846
GWgy7BqFdX0,11,35,2,48,0.22916666666666666,0.22916666666666666,0.7291666666666666
GYo9gRkmDG8,33,21,7,61,0.5409836065573771,0.5409836065573771,0.3442622950819672
GZRom6MxOng,3,0,0,3,1,1,0
G_kcmQr8yNY,8,49,1,58,0.13793103448275862,0.13793103448275862,0.8448275862068966
Gaf5i7o1ZmA,2,4,0,6,0.3333333333333333,0.3333333333333333,0.6666666666666666
Gb-iRvjTN60,10,9,1,20,0.5,0.5,0.45
GbA3QUbY88g,11,21,3,35,0.3142857142857143,0.3142857142857143,0.6
GcaLllWzQCg,11,15,2,28,0.39285714285714285,0.39285714285714285,0.5357142857142857
Gda_dPpyyos,174,117,12,303,0.5742574257425742,0.5742574257425742,0.38613861386138615
GeB_Ut2LD7k,146,291,51,488,0.29918032786885246,0.29918032786885246,0.5963114754098361
GfJs0-vtiuY,45,284,16,345,0.13043478260869565,0.13043478260869565,0.8231884057971014
GfgC0f1d_LU,8,24,0,32,0.25,0.25,0.75
Gg2H75gzQC8,54,104,32,190,0.28421052631578947,0.28421052631578947,0.5473684210526316
GgPFJaVhfBM,89,108,3,200,0.445,0.445,0.54
GgPxt38y9kY,16,47,5,68,0.23529411764705882,0.23529411764705882,0.6911764705882353
GgUxdamJ6ZY,131,145,13,289,0.4532871972318339,0.4532871972318339,0.5017301038062284
GhXofcSMPTE,3,19,1,23,0.13043478260869565,0.13043478260869565,0.8260869565217391
Git7TmCi2EU,7,11,1,19,0.3684210526315789,0.3684210526315789,0.5789473684210527
Gjg7mw-RADM,6,22,1,29,0.20689655172413793,0.20689655172413793,0.7586206896551724
Gk8Z_m29LnE,12,21,1,34,0.35294117647058826,0.35294117647058826,0.6176470588235294
Gm8NchAHOB0,7,12,2,21,0.3333333333333333,0.3333333333333333,0.5714285714285714
Gmk6yfGh3PU,4,10,2,16,0.25,0.25,0.625
GmzGqwz84lY,19,86,6,111,0.17117117117117117,0.17117117117117117,0.7747747747747747
Go-ZzOa31VY,19,21,6,46,0.41304347826086957,0.41304347826086957,0.45652173913043476
Gp2C9oQtLRg,11,16,0,27,0.4074074074074074,0.4074074074074074,0.5925925925925926
GpqspUCYxE8,26,32,3,61,0.4262295081967213,0.4262295081967213,0.5245901639344263
Groei9Sl1CE,12,25,5,42,0.2857142857142857,0.2857142857142857,0.5952380952380952
GseznzsMHnA,14,24,1,39,0.358974358974359,0.358974358974359,0.6153846153846154
Gsu3qW8PFw4,13,63,10,86,0.1511627906976744,0.1511627906976744,0.7325581395348837
GuD2p0oiBos,18,15,2,35,0.5142857142857142,0.5142857142857142,0.42857142857142855
GvvVRPIG-xs,6,3,2,11,0.5454545454545454,0.5454545454545454,0.2727272727272727
GxSifR1Z1fA,7,34,7,48,0.14583333333333334,0.14583333333333334,0.7083333333333334
GxzIswevjzM,10,10,0,20,0.5,0.5,0.5
Gz_vvRHJzYw,41,69,9,119,0.3445378151260504,0.3445378151260504,0.5798319327731093
H-9v6hFEWQM,4,1,1,6,0.6666666666666666,0.6666666666666666,0.16666666666666666
H-U2yLMX2S8,19,19,2,40,0.475,0.475,0.475
H0K3ciw_Cq8,11,69,4,84,0.13095238095238096,0.13095238095238096,0.8214285714285714
H0ilNY2JM48,1,5,0,6,0.16666666666666666,0.16666666666666666,0.8333333333333334
H1B3Kd21Gh4,1,5,0,6,0.16666666666666666,0.16666666666666666,0.8333333333333334
H1C9PYoPjQc,4,2,0,6,0.6666666666666666,0.6666666666666666,0.3333333333333333
H1LuVewyVhQ,6,3,3,12,0.5,0.5,0.25
H2GrM914tnU,4,18,2,24,0.16666666666666666,0.16666666666666666,0.75
H2Q0RKXUrVA,57,95,10,162,0.35185185185185186,0.35185185185185186,0.5864197530864198
H3Jme7WfW8c,3,6,3,12,0.25,0.25,0.5
H4V4BmfsPus,6,17,2,25,0.24,0.24,0.68
H5xqq0naiV8,21,13,1,35,0.6,0.6,0.37142857142857144
H6rtQBHG2sc,55,121,8,184,0.29891304347826086,0.29891304347826086,0.657608695652174
H6uQ5t1Jg0s,1,10,1,12,0.08333333333333333,0.08333333333333333,0.8333333333333334
H7MAG80-qKk,14,10,0,24,0.5833333333333334,0.5833333333333334,0.4166666666666667
H8QNknN8jP8,2,1,3,6,0.3333333333333333,0.3333333333333333,0.16666666666666666
HF48I8K--qk,12,37,1,50,0.24,0.24,0.74
HFxs9z_Euek,6,13,5,24,0.25,0.25,0.5416666666666666
HIUuscglHQY,120,81,8,209,0.5741626794258373,0.5741626794258373,0.3875598086124402
HJZP3SFev3A,38,24,4,66,0.5757575757575758,0.5757575757575758,0.36363636363636365
HJZoDtfOidc,25,24,9,58,0.43103448275862066,0.43103448275862066,0.41379310344827586
HJaSfnyJEYk,40,49,3,92,0.43478260869565216,0.43478260869565216,0.532608695652174
HKhfKKn-x3s,16,23,6,45,0.35555555555555557,0.35555555555555557,0.5111111111111111
HMatq_LWPX8,25,83,16,124,0.20161290322580644,0.20161290322580644,0.6693548387096774
HNY7WNNEy6w,9,11,0,20,0.45,0.45,0.55
HOZmt2f6xwY,6,14,1,21,0.2857142857142857,0.2857142857142857,0.6666666666666666
HP6U57ADvVc,10,12,2,24,0.4166666666666667,0.4166666666666667,0.5
HQ3zpLJACYM,20,29,4,53,0.37735849056603776,0.37735849056603776,0.5471698113207547
HSZSavu7Mdc,12,31,0,43,0.27906976744186046,0.27906976744186046,0.7209302325581395
HTHZneZJdWQ,6,11,0,17,0.35294117647058826,0.35294117647058826,0.6470588235294118
HT_N0dn-Kw0,59,27,2,88,0.6704545454545454,0.6704545454545454,0.3068181818181818
HUC-vd6A8qE,5,12,1,18,0.2777777777777778,0.2777777777777778,0.6666666666666666
HUCyUk_W6p8,12,37,8,57,0.21052631578947367,0.21052631578947367,0.6491228070175439
HUSB9zWhvkY,4,5,2,11,0.36363636363636365,0.36363636363636365,0.45454545454545453
HWDRMQH0KAs,1,1,0,2,0.5,0.5,0.5
HWKvlhYGvUg,90,281,21,392,0.22959183673469388,0.22959183673469388,0.7168367346938775
HWvElhEKrkU,1,1,0,2,0.5,0.5,0.5
HXFWSu-R9mY,3,7,1,11,0.2727272727272727,0.2727272727272727,0.6363636363636364
HZCNUkS0qjo,8,16,3,27,0.2962962962962963,0.2962962962962963,0.5925925925925926
H_-5-djAQ-0,7,45,4,56,0.125,0.125,0.8035714285714286
H_M3cYTt-yE,13,19,0,32,0.40625,0.40625,0.59375
Hay8solH8YY,4,3,0,7,0.5714285714285714,0.5714285714285714,0.42857142857142855
HbeUX5-HpVQ,3,10,1,14,0.21428571428571427,0.21428571428571427,0.7142857142857143
HbqJApd8vow,4,24,2,30,0.13333333333333333,0.13333333333333333,0.8
HcQ_Dp96gNM,17,23,0,40,0.425,0.425,0.575
HdiDwWd2HL4,8,20,4,32,0.25,0.25,0.625
HhbI5NFPmrs,10,7,1,18,0.5555555555555556,0.5555555555555556,0.3888888888888889
HiajUS3rty8,16,78,6,100,0.16,0.16,0.78
HildIOYyIJQ,6,12,2,20,0.3,0.3,0.6
HjEmL4UOPh4,22,38,4,64,0.34375,0.34375,0.59375
HktmncjU730,9,40,10,59,0.15254237288135594,0.15254237288135594,0.6779661016949152
Hly8rhELsN8,9,13,2,24,0.375,0.375,0.5416666666666666
HodXygNDiUc,20,27,3,50,0.4,0.4,0.54
HotWYech51Q,14,13,1,28,0.5,0.5,0.4642857142857143
HpJd3y5SnqA,10,30,2,42,0.23809523809523808,0.23809523809523808,0.7142857142857143
HqLTQarBH5s,18,12,6,36,0.5,0.5,0.3333333333333333
HqZIt05Jqic,82,213,22,317,0.2586750788643533,0.2586750788643533,0.6719242902208202
Hr5QwVYyPL8,9,20,2,31,0.2903225806451613,0.2903225806451613,0.6451612903225806
HsH8JdBpQA4,3,12,2,17,0.17647058823529413,0.17647058823529413,0.7058823529411765
HvF4VbgoIBg,74,72,16,162,0.4567901234567901,0.4567901234567901,0.4444444444444444
HvOIufnlP18,25,8,4,37,0.6756756756756757,0.6756756756756757,0.21621621621621623
Hw5ASePUCCc,9,13,5,27,0.3333333333333333,0.3333333333333333,0.48148148148148145
HwFIcqtdhQ0,59,35,7,101,0.5841584158415841,0.5841584158415841,0.3465346534653465
Hwyzl2p9cgA,7,14,3,24,0.2916666666666667,0.2916666666666667,0.5833333333333334
HxlQ2NofsoY,290,117,10,417,0.6954436450839329,0.6954436450839329,0.2805755395683453
HznDCpYnbOQ,15,61,8,84,0.17857142857142858,0.17857142857142858,0.7261904761904762
HzxeYOnxSJ0,10,22,1,33,0.30303030303030304,0.30303030303030304,0.6666666666666666
I1iZiMBR3o0,380,63,6,449,0.8463251670378619,0.8463251670378619,0.1403118040089087
I3eBwV04Wns,6,9,1,16,0.375,0.375,0.5625
I5UePnWsp6U,7,2,1,10,0.7,0.7,0.2
I6FECdkfIZc,18,50,15,83,0.21686746987951808,0.21686746987951808,0.6024096385542169
I7Bd4UcD4sE,9,6,0,15,0.6,0.6,0.4
I8FWJzJHtLA,7,6,2,15,0.4666666666666667,0.4666666666666667,0.4
I8IaEcYxvLg,22,33,1,56,0.39285714285714285,0.39285714285714285,0.5892857142857143
I96aKObwObA,17,79,22,118,0.1440677966101695,0.1440677966101695,0.6694915254237288
I9cULnKS8qA,18,65,7,90,0.2,0.2,0.7222222222222222
IAOuKtwaWMA,7,5,3,15,0.4666666666666667,0.4666666666666667,0.3333333333333333
IBh7wP_RodM,110,56,7,173,0.6358381502890174,0.6358381502890174,0.3236994219653179
IC_u5c7tyV4,51,36,12,99,0.5151515151515151,0.5151515151515151,0.36363636363636365
IEO3S3vCRvo,29,32,10,71,0.4084507042253521,0.4084507042253521,0.4507042253521127
IF7FfTnWG9w,3,16,1,20,0.15,0.15,0.8
IHDObcJ4-P8,29,37,4,70,0.4142857142857143,0.4142857142857143,0.5285714285714286
IIZPAcoH_qU,4,9,1,14,0.2857142857142857,0.2857142857142857,0.6428571428571429
IJbMPqJ88QY,5,5,0,10,0.5,0.5,0.5
IJyIrknHnaM,134,130,15,279,0.48028673835125446,0.48028673835125446,0.4659498207885305
IL65bgfOJvM,5,15,0,20,0.25,0.25,0.75
ILuyhFzNbNI,6,15,0,21,0.2857142857142857,0.2857142857142857,0.7142857142857143
ISfl3WsdX6A,8,4,1,13,0.6153846153846154,0.6153846153846154,0.3076923076923077
IUeHhlnxKew,5,32,4,41,0.12195121951219512,0.12195121951219512,0.7804878048780488
IUiMxaI4-EQ,737,3039,720,4496,0.163923487544484,0.163923487544484,0.6759341637010676
IVE6KLJDMDM,14,9,0,23,0.6086956521739131,0.6086956521739131,0.391304347826087
IVezrtNqHWg,21,50,1,72,0.2916666666666667,0.2916666666666667,0.6944444444444444
IWvWtVsnkA0,6,5,1,12,0.5,0.5,0.4166666666666667
IXJHXjFzq_Q,10,24,0,34,0.29411764705882354,0.29411764705882354,0.7058823529411765
I_GdZqx0S3s,6,3,0,9,0.6666666666666666,0.6666666666666666,0.3333333333333333
Ia2BjE2R6rc,8,7,0,15,0.5333333333333333,0.5333333333333333,0.4666666666666667
IbheG25BqH0,4,43,0,47,0.0851063829787234,0.0851063829787234,0.9148936170212766
IcDmHHZaycY,8,4,0,12,0.6666666666666666,0.6666666666666666,0.3333333333333333
IceG9TB_bTo,2,1,0,3,0.6666666666666666,0.6666666666666666,0.3333333333333333
IfZiLzCKSDg,20,43,2,65,0.3076923076923077,0.3076923076923077,0.6615384615384615
IibV85mINNY,11,17,0,28,0.39285714285714285,0.39285714285714285,0.6071428571428571
IixRZXna08k,99,196,24,319,0.3103448275862069,0.3103448275862069,0.6144200626959248
IjWakItspsU,0,5,1,6,0,0,0.8333333333333334
Ijxm3Z4LGgk,21,36,1,58,0.3620689655172414,0.3620689655172414,0.6206896551724138
IjyJWYmebuw,3,14,1,18,0.16666666666666666,0.16666666666666666,0.7777777777777778
IjyvbY1rk2g,11,27,2,40,0.275,0.275,0.675
Ik0uqr_5Ysg,18,32,2,52,0.34615384615384615,0.34615384615384615,0.6153846153846154
Ikjm2sxxujw,8,21,0,29,0.27586206896551724,0.27586206896551724,0.7241379310344828
IlC0bmrIn1g,10,38,3,51,0.19607843137254902,0.19607843137254902,0.7450980392156863
IlmpKvQb9zk,6,37,2,45,0.13333333333333333,0.13333333333333333,0.8222222222222222
ImjfyCys_gw,9,22,3,34,0.2647058823529412,0.2647058823529412,0.6470588235294118
ImowVdKQ2Nc,11,12,4,27,0.4074074074074074,0.4074074074074074,0.4444444444444444
InzWoJ22SRU,29,90,6,125,0.232,0.232,0.72
IpbX3HGCuQU,6,8,1,15,0.4,0.4,0.5333333333333333
Iq_Y_jqTkbE,12,27,5,44,0.2727272727272727,0.2727272727272727,0.6136363636363636
IqkUL2J9Reo,16,31,2,49,0.32653061224489793,0.32653061224489793,0.6326530612244898
Ir5aqdTmX7Q,1,2,0,3,0.3333333333333333,0.3333333333333333,0.6666666666666666
IrLDY-Wb6UE,107,35,3,145,0.7379310344827587,0.7379310344827587,0.2413793103448276
ItGrQOuy5IM,24,32,3,59,0.4067796610169492,0.4067796610169492,0.5423728813559322
ItJ9OQWsW6M,13,47,4,64,0.203125,0.203125,0.734375
ItkTFUvl_4Q,396,504,32,932,0.4248927038626609,0.4248927038626609,0.5407725321888412
IuK_ddd5GO0,1,2,0,3,0.3333333333333333,0.3333333333333333,0.6666666666666666
Iv-LnLZtDk0,32,35,5,72,0.4444444444444444,0.4444444444444444,0.4861111111111111
Ivox0hr0rCY,10,44,3,57,0.17543859649122806,0.17543859649122806,0.7719298245614035
Iw1SnVAnyQo,8,19,0,27,0.2962962962962963,0.2962962962962963,0.7037037037037037
Iy4aP66hXdQ,7,7,0,14,0.5,0.5,0.5
Iyb-qG1NXBc,31,68,8,107,0.2897196261682243,0.2897196261682243,0.6355140186915887
J-AsTb9R1HU,5,8,0,13,0.38461538461538464,0.38461538461538464,0.6153846153846154
J01iyZBhkvI,43,70,5,118,0.3644067796610169,0.3644067796610169,0.5932203389830508
J0f5ZN8uqaY,4,7,1,12,0.3333333333333333,0.3333333333333333,0.5833333333333334
J1wK8kxupRc,10,9,1,20,0.5,0.5,0.45
J2TO2v1uttg,7,12,2,21,0.3333333333333333,0.3333333333333333,0.5714285714285714
J3UywPDqIWE,1,3,2,6,0.16666666666666666,0.16666666666666666,0.5
J3xqZlKycGM,1,8,2,11,0.09090909090909091,0.09090909090909091,0.7272727272727273
J5PxwSFZ1ac,399,101,30,530,0.7528301886792453,0.7528301886792453,0.19056603773584907
J5bgT-SdW2s,12,5,1,18,0.6666666666666666,0.6666666666666666,0.2777777777777778
J5dT1cNmfHk,5,8,1,14,0.35714285714285715,0.35714285714285715,0.5714285714285714
J5i7SgLErUU,13,22,1,36,0.3611111111111111,0.3611111111111111,0.6111111111111112
J65pKXXMhc4,9,39,1,49,0.1836734693877551,0.1836734693877551,0.7959183673469388
J6GD2NgA5_o,38,165,18,221,0.17194570135746606,0.17194570135746606,0.746606334841629
J8pnqF9Q0Yc,51,45,5,101,0.504950495049505,0.504950495049505,0.44554455445544555
J9bws1w5MrU,87,41,17,145,0.6,0.6,0.2827586206896552
JAOp6LQR41I,24,50,7,81,0.2962962962962963,0.2962962962962963,0.6172839506172839
JAyivneFgBo,38,33,1,72,0.5277777777777778,0.5277777777777778,0.4583333333333333
JB0h3fUNVXw,20,36,4,60,0.3333333333333333,0.3333333333333333,0.6
JBDkKaqFN3Q,14,29,2,45,0.3111111111111111,0.3111111111111111,0.6444444444444445
JBGBZgICKEU,97,98,14,209,0.46411483253588515,0.46411483253588515,0.4688995215311005
JDODcHvhTc8,8,7,1,16,0.5,0.5,0.4375
JDczMPl5ECM,13,6,2,21,0.6190476190476191,0.6190476190476191,0.2857142857142857
JDf2m-o4yh4,58,162,20,240,0.24166666666666667,0.24166666666666667,0.675
JG12vz9x4I0,26,36,0,62,0.41935483870967744,0.41935483870967744,0.5806451612903226
JGDDJoRDoOk,7,11,0,18,0.3888888888888889,0.3888888888888889,0.6111111111111112
JGo1623MVnc,25,94,0,119,0.21008403361344538,0.21008403361344538,0.7899159663865546
JIfs18TAyYM,3,12,1,16,0.1875,0.1875,0.75
JLOFPFmv4Po,26,13,3,42,0.6190476190476191,0.6190476190476191,0.30952380952380953
JLd15Xw5IBI,17,36,1,54,0.3148148148148148,0.3148148148148148,0.6666666666666666
JM-h3uB286Q,13,3,1,17,0.7647058823529411,0.7647058823529411,0.17647058823529413
JMtUpt_c72E,26,111,2,139,0.18705035971223022,0.18705035971223022,0.7985611510791367
JMxZASXn30s,1,10,1,12,0.08333333333333333,0.08333333333333333,0.8333333333333334
JNAXdgrtqgI,13,35,1,49,0.2653061224489796,0.2653061224489796,0.7142857142857143
JNfjN4aG-bY,20,17,3,40,0.5,0.5,0.425
JQI9uILJ3UY,29,151,21,201,0.14427860696517414,0.14427860696517414,0.7512437810945274
JQhAP2RXyR0,2,3,1,6,0.3333333333333333,0.3333333333333333,0.5
JR1EkDJioRE,2,8,2,12,0.16666666666666666,0.16666666666666666,0.6666666666666666
JRGP6v6YtRU,7,2,3,12,0.5833333333333334,0.5833333333333334,0.16666666666666666
JSAYvMRGesI,27,16,1,44,0.6136363636363636,0.6136363636363636,0.36363636363636365
JSzzMjFl3Is,10,24,1,35,0.2857142857142857,0.2857142857142857,0.6857142857142857
JTseZwG7QZ4,30,44,7,81,0.37037037037037035,0.37037037037037035,0.5432098765432098
JUUbgVOKiUM,0,6,0,6,0,0,1
JVeVsaojpzw,177,152,19,348,0.5086206896551724,0.5086206896551724,0.4367816091954023
JWKcii3-S3k,19,37,4,60,0.31666666666666665,0.31666666666666665,0.6166666666666667
JXqn-IZvMTc,4,5,0,9,0.4444444444444444,0.4444444444444444,0.5555555555555556
JXvMj9RXg4U,78,201,30,309,0.2524271844660194,0.2524271844660194,0.6504854368932039
J_1xTsJjWDc,5,5,1,11,0.45454545454545453,0.45454545454545453,0.45454545454545453
J_bewYg-hG8,20,19,6,45,0.4444444444444444,0.4444444444444444,0.4222222222222222
JaHT46bVHdI,51,80,11,142,0.3591549295774648,0.3591549295774648,0.5633802816901409
JcWX50wkiOY,5,13,1,19,0.2631578947368421,0.2631578947368421,0.6842105263157895
Jcm0eWIpupI,14,39,2,55,0.2545454545454545,0.2545454545454545,0.7090909090909091
Jd9FotRjNHA,48,104,10,162,0.2962962962962963,0.2962962962962963,0.6419753086419753
JfcNpcIQGCU,1,6,0,7,0.14285714285714285,0.14285714285714285,0.8571428571428571
JgvpHswy5YI,19,51,0,70,0.2714285714285714,0.2714285714285714,0.7285714285714285
JhcqWK3NYFI,107,266,41,414,0.2584541062801932,0.2584541062801932,0.642512077294686
JjcJwUWeQfk,11,28,1,40,0.275,0.275,0.7
Jk2ZJ7Hd7hY,4,2,0,6,0.6666666666666666,0.6666666666666666,0.3333333333333333
JlIyg8SDcWs,7,6,1,14,0.5,0.5,0.42857142857142855
JltTZnxPx5k,304,208,28,540,0.562962962962963,0.562962962962963,0.3851851851851852
Jm5ayTvxAEU,7,14,1,22,0.3181818181818182,0.3181818181818182,0.6363636363636364
JmduPuxWDTc,7,5,1,13,0.5384615384615384,0.5384615384615384,0.38461538461538464
JmklNWdvx3c,3,3,1,7,0.42857142857142855,0.42857142857142855,0.42857142857142855
Jom95rr8T0k,15,30,3,48,0.3125,0.3125,0.625
JoptvvcRHg8,8,41,1,50,0.16,0.16,0.82
JoxErRMkxfs,53,63,60,176,0.30113636363636365,0.30113636363636365,0.35795454545454547
JpQSfqxcQ94,4,8,0,12,0.3333333333333333,0.3333333333333333,0.6666666666666666
JsEYDc6GjfE,47,36,3,86,0.5465116279069767,0.5465116279069767,0.4186046511627907
JsptAIbc8ag,16,16,1,33,0.48484848484848486,0.48484848484848486,0.48484848484848486
JuPoeEfjXLg,62,136,11,209,0.2966507177033493,0.2966507177033493,0.6507177033492823
Jvr-MWZxkOI,15,21,2,38,0.39473684210526316,0.39473684210526316,0.5526315789473685
JvwsGq3h7m0,3,4,0,7,0.42857142857142855,0.42857142857142855,0.5714285714285714
Jybt-SGgr2Q,24,21,5,50,0.48,0.48,0.42
JzO7MWTFIlU,66,85,11,162,0.4074074074074074,0.4074074074074074,0.5246913580246914
K0AswuYkb1c,65,76,3,144,0.4513888888888889,0.4513888888888889,0.5277777777777778
K117Nxd9Cqk,6,12,2,20,0.3,0.3,0.6
K1Ws0Tpn2d4,97,60,8,165,0.5878787878787879,0.5878787878787879,0.36363636363636365
K1p2IvIWd_g,22,50,1,73,0.3013698630136986,0.3013698630136986,0.684931506849315
K5lALHftSJ8,24,34,3,61,0.39344262295081966,0.39344262295081966,0.5573770491803278
K6qtAP9WGOk,18,5,2,25,0.72,0.72,0.2
K9E5q49oc3w,82,469,41,592,0.13851351351351351,0.13851351351351351,0.7922297297297297
KAz1T08cu34,9,15,1,25,0.36,0.36,0.6
KCyvwsncm2w,87,33,2,122,0.7131147540983607,0.7131147540983607,0.27049180327868855
KDXUc2nuoh0,11,9,1,21,0.5238095238095238,0.5238095238095238,0.42857142857142855
KDu3D9Muuig,0,3,1,4,0,0,0.75
KDuMbWzz06w,5,7,0,12,0.4166666666666667,0.4166666666666667,0.5833333333333334
KGaFOPyKOc0,8,31,5,44,0.18181818181818182,0.18181818181818182,0.7045454545454546
KGaWb7Bt0Yc,10,11,0,21,0.47619047619047616,0.47619047619047616,0.5238095238095238
KH4EpJfDrBQ,20,8,3,31,0.6451612903225806,0.6451612903225806,0.25806451612903225
KH5EnNUYT-M,5,4,1,10,0.5,0.5,0.4
KHLm12w9QM4,43,112,5,160,0.26875,0.26875,0.7
KHXtCBBt9BA,3,19,4,26,0.11538461538461539,0.11538461538461539,0.7307692307692307
KMALWohxyX4,1,0,1,2,0.5,0.5,0
KN3sSAFGPs8,5,20,2,27,0.18518518518518517,0.18518518518518517,0.7407407407407407
KNPABUcREKQ,47,52,4,103,0.4563106796116505,0.4563106796116505,0.5048543689320388
KO4iegDFEVI,3,15,2,20,0.15,0.15,0.75
KPqLt1r3fz4,3,2,0,5,0.6,0.6,0.4
KQDGBSa-u-8,11,18,4,33,0.3333333333333333,0.3333333333333333,0.5454545454545454
KRbg1hU7cb0,7,14,0,21,0.3333333333333333,0.3333333333333333,0.6666666666666666
KRtvLTUiirI,5,14,1,20,0.25,0.25,0.7
KSUQyktYOrI,53,59,2,114,0.4649122807017544,0.4649122807017544,0.5175438596491229
KShvpuEYnVI,25,177,26,228,0.10964912280701754,0.10964912280701754,0.7763157894736842
KW9eJi4LdYc,15,3,2,20,0.75,0.75,0.15
KXYEO2RRZG4,22,74,15,111,0.1981981981981982,0.1981981981981982,0.6666666666666666
KY0GXe7nuk8,9,24,6,39,0.23076923076923078,0.23076923076923078,0.6153846153846154
K_IrOWQTjBQ,29,47,3,79,0.3670886075949367,0.3670886075949367,0.5949367088607594
K_YgjjBxftA,25,12,2,39,0.6410256410256411,0.6410256410256411,0.3076923076923077
K_cS9ON421w,2,12,6,20,0.1,0.1,0.6
Ka6rj4u38lA,328,326,82,736,0.44565217391304346,0.44565217391304346,0.4429347826086957
KcLlCXxTUnA,18,19,0,37,0.4864864864864865,0.4864864864864865,0.5135135135135135
KcPNhOC98CQ,2,2,1,5,0.4,0.4,0.4
KcvVBpxPVDo,7,10,1,18,0.3888888888888889,0.3888888888888889,0.5555555555555556
Kdi1uNhEJNc,11,45,2,58,0.1896551724137931,0.1896551724137931,0.7758620689655172
KeFJC-SMHgY,6,9,1,16,0.375,0.375,0.5625
Kfh_BMvopEI,19,13,0,32,0.59375,0.59375,0.40625
KgH0P5hV1bg,7,17,2,26,0.2692307692307692,0.2692307692307692,0.6538461538461539
Kikc4PaEkys,13,17,2,32,0.40625,0.40625,0.53125
Kiln13VHfog,18,42,7,67,0.26865671641791045,0.26865671641791045,0.6268656716417911
KlRCk2EmDkU,8,22,3,33,0.24242424242424243,0.24242424242424243,0.6666666666666666
Klz2vm2dbAY,27,46,3,76,0.35526315789473684,0.35526315789473684,0.6052631578947368
KmUTlTOAZH4,3,1,0,4,0.75,0.75,0.25
Kmjte98jmTw,16,10,1,27,0.5925925925925926,0.5925925925925926,0.37037037037037035
Kmt1elQDQEc,12,6,0,18,0.6666666666666666,0.6666666666666666,0.3333333333333333
KnXCjIANYQE,1,2,1,4,0.25,0.25,0.5
Knd2UzQBQMU,5,5,3,13,0.38461538461538464,0.38461538461538464,0.38461538461538464
KnkgQX9gygg,13,39,4,56,0.23214285714285715,0.23214285714285715,0.6964285714285714
Ko47f-iIeNo,10,11,0,21,0.47619047619047616,0.47619047619047616,0.5238095238095238
KoNupQ7omb0,433,819,48,1300,0.3330769230769231,0.3330769230769231,0.63
KoUPRJw3iYY,27,24,5,56,0.48214285714285715,0.48214285714285715,0.42857142857142855
KoiIdKnSj5U,20,19,0,39,0.5128205128205128,0.5128205128205128,0.48717948717948717
Kph0Q-XP7PY,58,37,5,100,0.58,0.58,0.37
KphxDMLNOfQ,17,16,6,39,0.4358974358974359,0.4358974358974359,0.41025641025641024
KplqjpVhGLE,25,27,3,55,0.45454545454545453,0.45454545454545453,0.4909090909090909
Kr-kPTLRXW8,229,454,87,770,0.2974025974025974,0.2974025974025974,0.5896103896103896
KrbPq1XccCM,4,17,1,22,0.18181818181818182,0.18181818181818182,0.7727272727272727
Ks3FV-3QX2A,16,28,8,52,0.3076923076923077,0.3076923076923077,0.5384615384615384
Ku2WtzrrVdQ,84,66,4,154,0.5454545454545454,0.5454545454545454,0.42857142857142855
Kvju3ve8P8o,14,24,3,41,0.34146341463414637,0.34146341463414637,0.5853658536585366
Kw86ugKgimQ,3,1,0,4,0.75,0.75,0.25
KwWFljg5e5A,10,10,0,20,0.5,0.5,0.5
Ky4S3sx6hrw,16,39,3,58,0.27586206896551724,0.27586206896551724,0.6724137931034483
L1bPjisas8w,41,30,1,72,0.5694444444444444,0.5694444444444444,0.4166666666666667
L251I8SFDyU,186,103,5,294,0.6326530612244898,0.6326530612244898,0.35034013605442177
L3eka2c_aP4,203,78,14,295,0.688135593220339,0.688135593220339,0.26440677966101694
L3jISL9Yni8,32,11,2,45,0.7111111111111111,0.7111111111111111,0.24444444444444444
L49cjDXGqOQ,6,5,0,11,0.5454545454545454,0.5454545454545454,0.45454545454545453
L5OmjL_g1Ho,7,31,9,47,0.14893617021276595,0.14893617021276595,0.6595744680851063
L6Wc12otX0g,4,7,0,11,0.36363636363636365,0.36363636363636365,0.6363636363636364
L7cL8jEdbQg,30,48,5,83,0.3614457831325301,0.3614457831325301,0.5783132530120482
L7j3npMYvew,13,12,0,25,0.52,0.52,0.48
L9m-tmg-QLA,20,15,0,35,0.5714285714285714,0.5714285714285714,0.42857142857142855
LA1gzw4Jrz4,20,22,0,42,0.47619047619047616,0.47619047619047616,0.5238095238095238
LBJzyJwCvJI,13,8,1,22,0.5909090909090909,0.5909090909090909,0.36363636363636365
LBPnRS_AN0Y,17,10,0,27,0.6296296296296297,0.6296296296296297,0.37037037037037035
LE2fmrvu3R4,9,11,4,24,0.375,0.375,0.4583333333333333
LEBEgaUaRD0,9,14,1,24,0.375,0.375,0.5833333333333334
LEWgQv_t514,9,19,2,30,0.3,0.3,0.6333333333333333
LEeDwcEaIps,11,6,2,19,0.5789473684210527,0.5789473684210527,0.3157894736842105
LFwiF4G3m4U,15,19,4,38,0.39473684210526316,0.39473684210526316,0.5
LG0kLF-JkEQ,35,96,22,153,0.22875816993464052,0.22875816993464052,0.6274509803921569
LG_1SFjvDtA,33,28,3,64,0.515625,0.515625,0.4375
LH-FEAy0KXc,1,11,2,14,0.07142857142857142,0.07142857142857142,0.7857142857142857
LJiE5O5523g,9,32,4,45,0.2,0.2,0.7111111111111111
LJz4Gn4Mx6E,13,12,1,26,0.5,0.5,0.46153846153846156
LLuhfgAdHhw,5,18,1,24,0.20833333333333334,0.20833333333333334,0.75
LMIg-wABj_k,9,9,2,20,0.45,0.45,0.45
LNnHHju-uiU,3,6,0,9,0.3333333333333333,0.3333333333333333,0.6666666666666666
LPC6JtKjdVc,5,36,1,42,0.11904761904761904,0.11904761904761904,0.8571428571428571
LQ6DyHsl-nY,5,19,1,25,0.2,0.2,0.76
LRLCz097LdI,7,34,3,44,0.1590909090909091,0.1590909090909091,0.7727272727272727
LS3PsC8C5tE,16,4,1,21,0.7619047619047619,0.7619047619047619,0.19047619047619047
LSOdHZ5KKaI,180,109,14,303,0.594059405940594,0.594059405940594,0.35973597359735976
LZk8uKIkiz0,2,11,0,13,0.15384615384615385,0.15384615384615385,0.8461538461538461
L_TccxwTSks,11,17,2,30,0.36666666666666664,0.36666666666666664,0.5666666666666667
LdTYdoBZKhI,6,15,1,22,0.2727272727272727,0.2727272727272727,0.6818181818181818
Lev1easUmHQ,54,37,6,97,0.5567010309278351,0.5567010309278351,0.38144329896907214
Lfbs5m-b-sc,9,7,1,17,0.5294117647058824,0.5294117647058824,0.4117647058823529
LhCi5S9Ui7k,22,85,4,111,0.1981981981981982,0.1981981981981982,0.7657657657657657
LhMbdv03wgs,5,5,1,11,0.45454545454545453,0.45454545454545453,0.45454545454545453
Li0tk9A21JM,16,11,2,29,0.5517241379310345,0.5517241379310345,0.3793103448275862
LiZ3Auz5Pe0,4,26,4,34,0.11764705882352941,0.11764705882352941,0.7647058823529411
LjQjyixPEnk,1,3,0,4,0.25,0.25,0.75
Lk5oD5LJj1s,2,3,0,5,0.4,0.4,0.6
Lkf5xG8njm8,4,3,2,9,0.4444444444444444,0.4444444444444444,0.3333333333333333
LnDBooqMYyU,7,17,0,24,0.2916666666666667,0.2916666666666667,0.7083333333333334
LndObq4ZN5U,5,8,1,14,0.35714285714285715,0.35714285714285715,0.5714285714285714
LobqnIrT5HA,5,67,2,74,0.06756756756756757,0.06756756756756757,0.9054054054054054
LpBCksmrcs8,5,6,1,12,0.4166666666666667,0.4166666666666667,0.5
LqpBT-gVNZ0,5,16,0,21,0.23809523809523808,0.23809523809523808,0.7619047619047619
LrMAivrlztw,7,11,1,19,0.3684210526315789,0.3684210526315789,0.5789473684210527
LrPfqbjYlY8,3,1,1,5,0.6,0.6,0.2
LsSI6nrcJ9M,63,135,19,217,0.2903225806451613,0.2903225806451613,0.6221198156682027
Lur8GwRTiiQ,71,36,7,114,0.6228070175438597,0.6228070175438597,0.3157894736842105
LvrCve6aqhE,19,12,2,33,0.5757575757575758,0.5757575757575758,0.36363636363636365
LysBCU_sotQ,27,20,2,49,0.5510204081632653,0.5510204081632653,0.40816326530612246
Lz1nx8uvk-k,13,20,3,36,0.3611111111111111,0.3611111111111111,0.5555555555555556
Lzz0wuQORrs,3,7,1,11,0.2727272727272727,0.2727272727272727,0.6363636363636364
M-4t2iAkBOU,1,7,0,8,0.125,0.125,0.875
M-Eh5NZtIiM,21,23,8,52,0.40384615384615385,0.40384615384615385,0.4423076923076923
M-GUKxNqArY,1,5,0,6,0.16666666666666666,0.16666666666666666,0.8333333333333334
M-XMnj03aV0,192,653,34,879,0.21843003412969283,0.21843003412969283,0.7428896473265074
M1EPAXK2ThA,30,23,1,54,0.5555555555555556,0.5555555555555556,0.42592592592592593
M1bUuGK4puI,239,117,25,381,0.6272965879265092,0.6272965879265092,0.30708661417322836
M1cljI2IRLk,3,5,2,10,0.3,0.3,0.5
M230yx9ryqE,1,2,1,4,0.25,0.25,0.5
M5W74UqB61w,16,21,2,39,0.41025641025641024,0.41025641025641024,0.5384615384615384
M62P3VHhZgQ,7,52,3,62,0.11290322580645161,0.11290322580645161,0.8387096774193549
M6gb-o3Yt3Y,58,53,3,114,0.5087719298245614,0.5087719298245614,0.4649122807017544
M85d4AJhIWM,52,57,8,117,0.4444444444444444,0.4444444444444444,0.48717948717948717
M8GwjB0St7I,10,12,0,22,0.45454545454545453,0.45454545454545453,0.5454545454545454
M8ayDZT795g,24,45,2,71,0.3380281690140845,0.3380281690140845,0.6338028169014085
M933sQm5NUc,5,8,2,15,0.3333333333333333,0.3333333333333333,0.5333333333333333
M9az4S5Q9NE,52,51,8,111,0.46846846846846846,0.46846846846846846,0.4594594594594595
MBJGYdsgs7k,8,24,5,37,0.21621621621621623,0.21621621621621623,0.6486486486486487
MBPDZ4-H45E,5,9,3,17,0.29411764705882354,0.29411764705882354,0.5294117647058824
MCABURlbpCM,13,6,3,22,0.5909090909090909,0.5909090909090909,0.2727272727272727
MCyx4HsIzMA,5,9,0,14,0.35714285714285715,0.35714285714285715,0.6428571428571429
MDc7HYrltxc,123,181,33,337,0.3649851632047478,0.3649851632047478,0.5370919881305638
MEC0Wjs1sU4,33,23,7,63,0.5238095238095238,0.5238095238095238,0.36507936507936506
MF5X0zleTqc,88,41,8,137,0.6423357664233577,0.6423357664233577,0.29927007299270075
MFn2dhgfG2U,11,36,6,53,0.20754716981132076,0.20754716981132076,0.6792452830188679
MHBE7BBsRWw,8,26,0,34,0.23529411764705882,0.23529411764705882,0.7647058823529411
MHe3a4bsp1U,6,4,0,10,0.6,0.6,0.4
MHrhSX6unI0,413,170,51,634,0.6514195583596214,0.6514195583596214,0.26813880126182965
MIrISWXiDzM,0,4,2,6,0,0,0.6666666666666666
MIyhf5iSB-w,12,1,0,13,0.9230769230769231,0.9230769230769231,0.07692307692307693
MKelaZ2eCtI,30,36,1,67,0.44776119402985076,0.44776119402985076,0.5373134328358209
ML27RpHso3E,8,7,1,16,0.5,0.5,0.4375
MLgZTU_StH4,7,42,4,53,0.1320754716981132,0.1320754716981132,0.7924528301886793
MLsCCzsZLVs,10,18,2,30,0.3333333333333333,0.3333333333333333,0.6
MLuNFZ_Oxcs,16,4,2,22,0.7272727272727273,0.7272727272727273,0.18181818181818182
MLxQSr8E2JM,1,2,0,3,0.3333333333333333,0.3333333333333333,0.6666666666666666
MMgFp9Ed-JU,612,262,36,910,0.6725274725274726,0.6725274725274726,0.2879120879120879
MMq1Ra8fCFs,3,1,0,4,0.75,0.75,0.25
MNHg2I_IB6o,67,19,4,90,0.7444444444444445,0.7444444444444445,0.2111111111111111
MNMPTI6BgLc,84,331,23,438,0.1917808219178082,0.1917808219178082,0.7557077625570776
MNPsvGkwwb4,10,48,3,61,0.16393442622950818,0.16393442622950818,0.7868852459016393
MP4ANIRnR6o,54,50,3,107,0.5046728971962616,0.5046728971962616,0.4672897196261682
MU6y3Pr2qnU,6,9,2,17,0.35294117647058826,0.35294117647058826,0.5294117647058824
MUPGqGHh07I,3,26,2,31,0.0967741935483871,0.0967741935483871,0.8387096774193549
MUhTkmew3o8,6,9,0,15,0.4,0.4,0.6
MV7Ov_cM_MU,51,179,24,254,0.20078740157480315,0.20078740157480315,0.7047244094488189
MVrRmSCVv6U,7,31,1,39,0.1794871794871795,0.1794871794871795,0.7948717948717948
MYzYT8lny2E,21,15,1,37,0.5675675675675675,0.5675675675675675,0.40540540540540543
M_tSp2mBdHA,31,45,9,85,0.36470588235294116,0.36470588235294116,0.5294117647058824
Ma37RNjHHf0,20,22,3,45,0.4444444444444444,0.4444444444444444,0.4888888888888889
Ma4Hdstm7yI,1278,3425,742,5445,0.23471074380165288,0.23471074380165288,0.6290174471992653
MaZKR5MGeOA,9,2,0,11,0.8181818181818182,0.8181818181818182,0.18181818181818182
McjynP5pAuM,39,124,24,187,0.20855614973262032,0.20855614973262032,0.6631016042780749
Md-RmEFwKXQ,169,34,8,211,0.8009478672985783,0.8009478672985783,0.16113744075829384
MdFIqvTTNpc,275,653,147,1075,0.2558139534883721,0.2558139534883721,0.6074418604651163
Mdbmyb5H2H4,11,24,3,38,0.2894736842105263,0.2894736842105263,0.631578947368421
MeS1GpOSyGo,6,18,4,28,0.21428571428571427,0.21428571428571427,0.6428571428571429
MefW8h_Mn2g,10,39,5,54,0.18518518518518517,0.18518518518518517,0.7222222222222222
MhAhN-Fipbo,190,99,17,306,0.6209150326797386,0.6209150326797386,0.3235294117647059
MhrLT6D4gXs,4,4,0,8,0.5,0.5,0.5
Miz7et4yB-8,5,24,0,29,0.1724137931034483,0.1724137931034483,0.8275862068965517
MjVO10u0wRg,19,24,2,45,0.4222222222222222,0.4222222222222222,0.5333333333333333
MkQU4AWOrxU,3,0,0,3,1,1,0
MlF0uSgs6sI,115,63,14,192,0.5989583333333334,0.5989583333333334,0.328125
MlYMWV7vBqU,63,282,22,367,0.17166212534059946,0.17166212534059946,0.7683923705722071
MmKJEPCm2LY,27,29,5,61,0.4426229508196721,0.4426229508196721,0.47540983606557374
Mmb3LigbxJw,83,132,19,234,0.3547008547008547,0.3547008547008547,0.5641025641025641
MmgS57U0ha8,7,17,0,24,0.2916666666666667,0.2916666666666667,0.7083333333333334
MtY4qdWbH6A,10,37,4,51,0.19607843137254902,0.19607843137254902,0.7254901960784313
Mtvf5wtjmmE,29,25,3,57,0.5087719298245614,0.5087719298245614,0.43859649122807015
Mtw1-B601FE,7,24,2,33,0.21212121212121213,0.21212121212121213,0.7272727272727273
Mul7ropqQSI,3,5,0,8,0.375,0.375,0.625
MvIkRTQd5FQ,16,24,3,43,0.37209302325581395,0.37209302325581395,0.5581395348837209
MvtMfuDBhuI,3,10,3,16,0.1875,0.1875,0.625
MxDXKS3jK4U,122,582,71,775,0.15741935483870967,0.15741935483870967,0.7509677419354839
MxseNqQi8LY,10,4,1,15,0.6666666666666666,0.6666666666666666,0.26666666666666666
MyHx4-_foc8,28,26,1,55,0.509090909090909,0.509090909090909,0.4727272727272727
MzjDCSVv7-c,7,12,5,24,0.2916666666666667,0.2916666666666667,0.5
Mztfno8ofXI,3,11,1,15,0.2,0.2,0.7333333333333333
N-5W23OUajE,8,34,1,43,0.18604651162790697,0.18604651162790697,0.7906976744186046
N00ihOlHSwY,5,17,0,22,0.22727272727272727,0.22727272727272727,0.7727272727272727
N24tWh39WU0,16,13,0,29,0.5517241379310345,0.5517241379310345,0.4482758620689655
N2LjiivX7IQ,10,11,1,22,0.45454545454545453,0.45454545454545453,0.5
N2_p364q0jM,4,13,0,17,0.23529411764705882,0.23529411764705882,0.7647058823529411
N3R_ScV-r7c,3,4,0,7,0.42857142857142855,0.42857142857142855,0.5714285714285714
N3UHDCNeTEs,11,30,4,45,0.24444444444444444,0.24444444444444444,0.6666666666666666
N4cnLvRlb50,21,49,5,75,0.28,0.28,0.6533333333333333
N5PR1HTQo38,221,112,22,355,0.6225352112676056,0.6225352112676056,0.3154929577464789
N5Qi0Z1kBTM,10,31,2,43,0.23255813953488372,0.23255813953488372,0.7209302325581395
N6CicgCFtp8,3,15,0,18,0.16666666666666666,0.16666666666666666,0.8333333333333334
N6DjR-fI0IA,30,176,20,226,0.13274336283185842,0.13274336283185842,0.7787610619469026
N7n3m_P80pI,47,145,6,198,0.23737373737373738,0.23737373737373738,0.7323232323232324
N8VE4tcIc8s,81,92,14,187,0.43315508021390375,0.43315508021390375,0.4919786096256685
N8aM3yXH-38,118,82,19,219,0.5388127853881278,0.5388127853881278,0.3744292237442922
NAZ9hPmXJlE,31,71,4,106,0.29245283018867924,0.29245283018867924,0.6698113207547169
NC7c_guCTSQ,23,12,4,39,0.5897435897435898,0.5897435897435898,0.3076923076923077
NCYPyO-6PP4,7,34,1,42,0.16666666666666666,0.16666666666666666,0.8095238095238095
NCmB_m06Ki8,5,20,2,27,0.18518518518518517,0.18518518518518517,0.7407407407407407
NCn2i6Aa4cE,36,12,6,54,0.6666666666666666,0.6666666666666666,0.2222222222222222
NDpzdW4z18M,23,17,5,45,0.5111111111111111,0.5111111111111111,0.37777777777777777
NDycro0vlE8,76,92,10,178,0.42696629213483145,0.42696629213483145,0.5168539325842697
NE8HJHR_A5k,7,0,0,7,1,1,0
NG4S77Hj6CU,5,45,1,51,0.09803921568627451,0.09803921568627451,0.8823529411764706
NGqBmcKavfQ,3,13,0,16,0.1875,0.1875,0.8125
NHawB-By9XU,5,23,3,31,0.16129032258064516,0.16129032258064516,0.7419354838709677
NJ8f0SEi7uU,12,28,4,44,0.2727272727272727,0.2727272727272727,0.6363636363636364
NK7jBhosimI,7,3,0,10,0.7,0.7,0.3
NLhDpejsyQM,0,2,0,2,0,0,1
NNw839d2SuA,10,5,1,16,0.625,0.625,0.3125
NRmsUh5Lc8k,6,11,1,18,0.3333333333333333,0.3333333333333333,0.6111111111111112
NTBQmCHjtxw,9,6,2,17,0.5294117647058824,0.5294117647058824,0.35294117647058826
NUYVXJTQvOc,25,17,3,45,0.5555555555555556,0.5555555555555556,0.37777777777777777
NVDDpm2iu_Y,6,15,1,22,0.2727272727272727,0.2727272727272727,0.6818181818181818
NVQsfcAM8OM,5,18,2,25,0.2,0.2,0.72
NVrChDPbuBc,29,34,7,70,0.4142857142857143,0.4142857142857143,0.4857142857142857
NVxl41tkggM,16,30,0,46,0.34782608695652173,0.34782608695652173,0.6521739130434783
NW0PKgWSlw0,16,26,4,46,0.34782608695652173,0.34782608695652173,0.5652173913043478
NXQT_aEpnO0,4,3,2,9,0.4444444444444444,0.4444444444444444,0.3333333333333333
NZ_jPZo2Sxo,3,5,1,9,0.3333333333333333,0.3333333333333333,0.5555555555555556
NaFq5nNR4oM,11,37,3,51,0.21568627450980393,0.21568627450980393,0.7254901960784313
Nb6MpOGiRzY,12,28,4,44,0.2727272727272727,0.2727272727272727,0.6363636363636364
NbCkke3iwoU,23,94,5,122,0.1885245901639344,0.1885245901639344,0.7704918032786885
NcyMfbcLFok,2,15,1,18,0.1111111111111111,0.1111111111111111,0.8333333333333334
NdYAHjpT3-M,22,29,4,55,0.4,0.4,0.5272727272727272
Ndwu73AKX2c,68,91,8,167,0.40718562874251496,0.40718562874251496,0.5449101796407185
NhhVQCrvoVs,25,26,6,57,0.43859649122807015,0.43859649122807015,0.45614035087719296
NjpkBxta1kY,2,8,1,11,0.18181818181818182,0.18181818181818182,0.7272727272727273
Njv9HHWTfqs,25,18,1,44,0.5681818181818182,0.5681818181818182,0.4090909090909091
NkZ10wYO-zQ,19,82,7,108,0.17592592592592593,0.17592592592592593,0.7592592592592593
NkyiOQb68ZQ,1,5,0,6,0.16666666666666666,0.16666666666666666,0.8333333333333334
NmMydxdyQDk,13,21,2,36,0.3611111111111111,0.3611111111111111,0.5833333333333334
NmzQSJmn65Q,215,145,28,388,0.5541237113402062,0.5541237113402062,0.37371134020618557
NnNG6LclXEI,15,31,3,49,0.30612244897959184,0.30612244897959184,0.6326530612244898
NoVR9R9L5aE,7,9,1,17,0.4117647058823529,0.4117647058823529,0.5294117647058824
NorgEYpqpog,5,37,6,48,0.10416666666666667,0.10416666666666667,0.7708333333333334
NqzKkHQ7_OI,2,25,2,29,0.06896551724137931,0.06896551724137931,0.8620689655172413
NryFegQeS5M,21,10,2,33,0.6363636363636364,0.6363636363636364,0.30303030303030304
NsMj0dy3dL8,11,8,0,19,0.5789473684210527,0.5789473684210527,0.42105263157894735
NsNfO-x3SxQ,5,6,1,12,0.4166666666666667,0.4166666666666667,0.5
NsTSa2ijphE,4,15,1,20,0.2,0.2,0.75
NsheaTB8LCo,14,6,1,21,0.6666666666666666,0.6666666666666666,0.2857142857142857
Nsjdfj9YJEg,52,28,6,86,0.6046511627906976,0.6046511627906976,0.32558139534883723
NtKBrtfJgas,55,119,6,180,0.3055555555555556,0.3055555555555556,0.6611111111111111
NtR9XNQeO6w,4,4,1,9,0.4444444444444444,0.4444444444444444,0.4444444444444444
Ntr-moqLKs4,6,9,0,15,0.4,0.4,0.6
NttIRcy55Ig,6,10,2,18,0.3333333333333333,0.3333333333333333,0.5555555555555556
Nv0bZGNhlgA,38,40,6,84,0.4523809523809524,0.4523809523809524,0.47619047619047616
Nw_5ue5j92g,32,15,3,50,0.64,0.64,0.3
NwtKAk1asnY,2,21,5,28,0.07142857142857142,0.07142857142857142,0.75
Nx39HmYX5d4,3,7,1,11,0.2727272727272727,0.2727272727272727,0.6363636363636364
NxTpbhRztQM,22,45,7,74,0.2972972972972973,0.2972972972972973,0.6081081081081081
NyaSYMSDTDE,15,54,6,75,0.2,0.2,0.72
NydeWNDcqL8,35,85,8,128,0.2734375,0.2734375,0.6640625
NzN6PwU0liQ,2,19,4,25,0.08,0.08,0.76
O-FFGwm_kNc,5,16,1,22,0.22727272727272727,0.22727272727272727,0.7272727272727273
O-cKR-QTeOU,51,91,12,154,0.33116883116883117,0.33116883116883117,0.5909090909090909
O-el8iKZNEI,13,13,1,27,0.48148148148148145,0.48148148148148145,0.48148148148148145
O0N9XeoA9kQ,11,64,6,81,0.13580246913580246,0.13580246913580246,0.7901234567901234
O0g0hSkxqts,1,18,1,20,0.05,0.05,0.9
O0vhxBvM-Gk,8,27,2,37,0.21621621621621623,0.21621621621621623,0.7297297297297297
O1JBnVEdT1w,1,2,0,3,0.3333333333333333,0.3333333333333333,0.6666666666666666
O4xcGyVDydY,0,1,0,1,0,0,1
O53m-KSCJCw,2,5,1,8,0.25,0.25,0.625
O6iAtOgppss,11,32,4,47,0.23404255319148937,0.23404255319148937,0.6808510638297872
O80ZxesbuIg,85,76,8,169,0.5029585798816568,0.5029585798816568,0.44970414201183434
O88m0TTf724,9,7,0,16,0.5625,0.5625,0.4375
OA2MuTjW9e0,14,47,6,67,0.208955223880597,0.208955223880597,0.7014925373134329
OAAn25dm49U,4,22,1,27,0.14814814814814814,0.14814814814814814,0.8148148148148148
OBKmymnu22Y,47,38,3,88,0.5340909090909091,0.5340909090909091,0.4318181818181818
OBwxUDQ-gLw,31,129,19,179,0.17318435754189945,0.17318435754189945,0.7206703910614525
OCnLIkgikws,5,6,0,11,0.45454545454545453,0.45454545454545453,0.5454545454545454
OCqbqlH04K0,15,11,3,29,0.5172413793103449,0.5172413793103449,0.3793103448275862
OCydcpHp1Ls,7,43,1,51,0.13725490196078433,0.13725490196078433,0.8431372549019608
OFbXmxC0MzU,73,23,4,100,0.73,0.73,0.23
OG9_i6CY-Z4,81,56,4,141,0.574468085106383,0.574468085106383,0.3971631205673759
OGMuC1Z7KFQ,8,4,1,13,0.6153846153846154,0.6153846153846154,0.3076923076923077
OIgFwR3iTfQ,4,18,4,26,0.15384615384615385,0.15384615384615385,0.6923076923076923
OIjZ4ewmjCc,10,1,0,11,0.9090909090909091,0.9090909090909091,0.09090909090909091
OJ35OWIZIz0,19,31,2,52,0.36538461538461536,0.36538461538461536,0.5961538461538461
OJE0Ga9Z6GQ,4,8,0,12,0.3333333333333333,0.3333333333333333,0.6666666666666666
OJbB8OW7aHY,1,7,0,8,0.125,0.125,0.875
OJf88b8gfEU,9,13,0,22,0.4090909090909091,0.4090909090909091,0.5909090909090909
OKOSqM08wzs,39,24,3,66,0.5909090909090909,0.5909090909090909,0.36363636363636365
OKdVnBEieL0,2,2,2,6,0.3333333333333333,0.3333333333333333,0.3333333333333333
OKunP3smb8g,58,41,19,118,0.4915254237288136,0.4915254237288136,0.3474576271186441
OLag3l3eQlU,14,53,8,75,0.18666666666666668,0.18666666666666668,0.7066666666666667
ONyRteUzShA,3,18,1,22,0.13636363636363635,0.13636363636363635,0.8181818181818182
OOJkIwWOZDI,1,2,0,3,0.3333333333333333,0.3333333333333333,0.6666666666666666
OPFapPGChlI,13,13,0,26,0.5,0.5,0.5
OQebWFdk1-w,17,12,2,31,0.5483870967741935,0.5483870967741935,0.3870967741935484
ORz2yUlcpy4,16,21,2,39,0.41025641025641024,0.41025641025641024,0.5384615384615384
OTVzfkcV7Ws,5,7,0,12,0.4166666666666667,0.4166666666666667,0.5833333333333334
OUCwLX1ffC0,19,23,4,46,0.41304347826086957,0.41304347826086957,0.5
OVJqWpLWVbU,16,70,2,88,0.18181818181818182,0.18181818181818182,0.7954545454545454
OVSpbygzycM,16,29,2,47,0.3404255319148936,0.3404255319148936,0.6170212765957447
OWdKwA3ciTc,88,250,13,351,0.25071225071225073,0.25071225071225073,0.7122507122507122
OXM7GW542kE,12,5,2,19,0.631578947368421,0.631578947368421,0.2631578947368421
OYH9sOaLy2Q,8,2,0,10,0.8,0.8,0.2
OYKiRdeTZAU,30,135,9,174,0.1724137931034483,0.1724137931034483,0.7758620689655172
OZHAfE7s4lM,2,14,0,16,0.125,0.125,0.875
OZxQgyWZCkc,10,6,0,16,0.625,0.625,0.375
O_MmZFJA1KA,62,48,3,113,0.5486725663716814,0.5486725663716814,0.4247787610619469
O_i6itlpB6E,9,5,0,14,0.6428571428571429,0.6428571428571429,0.35714285714285715
OaBS70llrq8,23,11,1,35,0.6571428571428571,0.6571428571428571,0.3142857142857143
OcEaxkwNQYw,18,34,4,56,0.32142857142857145,0.32142857142857145,0.6071428571428571
OcEncj0-mUM,9,4,0,13,0.6923076923076923,0.6923076923076923,0.3076923076923077
OdR05d5dYRE,6,12,0,18,0.3333333333333333,0.3333333333333333,0.6666666666666666
Oe-UefeA6Ns,83,41,7,131,0.6335877862595419,0.6335877862595419,0.31297709923664124
OeT41Xv5t0s,122,93,38,253,0.48221343873517786,0.48221343873517786,0.3675889328063241
OeaO95lmSw8,13,108,7,128,0.1015625,0.1015625,0.84375
Oex08wCd0DQ,6,23,2,31,0.1935483870967742,0.1935483870967742,0.7419354838709677
OfjEB7cyWhU,7,8,1,16,0.4375,0.4375,0.5
Og4kh0x_jNI,3,0,1,4,0.75,0.75,0
Ojf3BIhBhWk,3,4,1,8,0.375,0.375,0.5
OkJ1PhNe38M,360,75,19,454,0.7929515418502202,0.7929515418502202,0.16519823788546256
OnX3MZJXTLw,55,42,6,103,0.5339805825242718,0.5339805825242718,0.4077669902912621
OnZ82NvWD24,8,10,1,19,0.42105263157894735,0.42105263157894735,0.5263157894736842
OniFZs14_-I,23,34,2,59,0.3898305084745763,0.3898305084745763,0.576271186440678
Onqyw_rTzeU,15,10,0,25,0.6,0.6,0.4
Ooyqaxc9OU4,3,18,1,22,0.13636363636363635,0.13636363636363635,0.8181818181818182
Oq79aDi-B60,1,3,0,4,0.25,0.25,0.75
OqfJ0kpZy00,46,52,10,108,0.42592592592592593,0.42592592592592593,0.48148148148148145
OsQl7il4Cgk,10,22,4,36,0.2777777777777778,0.2777777777777778,0.6111111111111112
Os_MXGCWMj0,29,149,11,189,0.15343915343915343,0.15343915343915343,0.7883597883597884
OuQPxTLBYsA,28,22,1,51,0.5490196078431373,0.5490196078431373,0.43137254901960786
OvXxJ-SdKZk,8,16,0,24,0.3333333333333333,0.3333333333333333,0.6666666666666666
OvaSPde7cN0,4,12,0,16,0.25,0.25,0.75
OvrhC5NAIn8,11,19,2,32,0.34375,0.34375,0.59375
OwOTmaakRwA,4,6,1,11,0.36363636363636365,0.36363636363636365,0.5454545454545454
Owyar5h4y70,3,6,0,9,0.3333333333333333,0.3333333333333333,0.6666666666666666
OxanmV-EE3A,10,18,2,30,0.3333333333333333,0.3333333333333333,0.6
OyUq6Jz4usg,19,30,10,59,0.3220338983050847,0.3220338983050847,0.5084745762711864
OyyBuO07t9U,16,30,1,47,0.3404255319148936,0.3404255319148936,0.6382978723404256
P-2qynUu414,2,7,1,10,0.2,0.2,0.7
P-gZ7jU5jUM,8,18,1,27,0.2962962962962963,0.2962962962962963,0.6666666666666666
P-i-jjt1Inw,5,8,1,14,0.35714285714285715,0.35714285714285715,0.5714285714285714
P1EO2H4hvKA,11,7,2,20,0.55,0.55,0.35
P2PpN2u4NdM,14,25,5,44,0.3181818181818182,0.3181818181818182,0.5681818181818182
P2VLOT1_LiM,3,25,2,30,0.1,0.1,0.8333333333333334
P3CF03TChSg,36,35,4,75,0.48,0.48,0.4666666666666667
P3mmGUbhmuo,45,9,2,56,0.8035714285714286,0.8035714285714286,0.16071428571428573
P4lC3n2X-0Q,20,22,2,44,0.45454545454545453,0.45454545454545453,0.5
P5-Tcos-vv0,16,7,1,24,0.6666666666666666,0.6666666666666666,0.2916666666666667
P534V1JyLd8,3,16,3,22,0.13636363636363635,0.13636363636363635,0.7272727272727273
P5tf96pL6PY,1,9,3,13,0.07692307692307693,0.07692307692307693,0.6923076923076923
P69qAD_MSus,5,14,0,19,0.2631578947368421,0.2631578947368421,0.7368421052631579
P7EVUr2SLJ8,3,14,0,17,0.17647058823529413,0.17647058823529413,0.8235294117647058
P80xEYT_jGU,5,17,2,24,0.20833333333333334,0.20833333333333334,0.7083333333333334
P8jHdlI_oT4,34,91,4,129,0.26356589147286824,0.26356589147286824,0.7054263565891473
P95bfI3qk3E,17,15,1,33,0.5151515151515151,0.5151515151515151,0.45454545454545453
P9VeIOcFOfQ,5,12,1,18,0.2777777777777778,0.2777777777777778,0.6666666666666666
P9bMVScFgn8,10,10,0,20,0.5,0.5,0.5
PCiMXm3kfMc,21,32,3,56,0.375,0.375,0.5714285714285714
PD0ydiBbakA,14,12,1,27,0.5185185185185185,0.5185185185185185,0.4444444444444444
PDcem_iOV1M,13,5,0,18,0.7222222222222222,0.7222222222222222,0.2777777777777778
PDh9AOSvm-E,7,19,0,26,0.2692307692307692,0.2692307692307692,0.7307692307692307
PDrwu0Tj1e8,1,1,0,2,0.5,0.5,0.5
PHMJT0xVbzs,6,4,2,12,0.5,0.5,0.3333333333333333
PHeCh9vuwnM,61,51,5,117,0.5213675213675214,0.5213675213675214,0.4358974358974359
PJ5JHYTL9OY,8,8,0,16,0.5,0.5,0.5
PJOsZ9Vspvc,20,34,4,58,0.3448275862068966,0.3448275862068966,0.5862068965517241
PJYPABnOqRA,158,340,50,548,0.28832116788321166,0.28832116788321166,0.6204379562043796
PKYz-ez7tVk,0,3,0,3,0,0,1
PKa1vKwN0n8,4,18,2,24,0.16666666666666666,0.16666666666666666,0.75
PKipg3EnRMM,22,48,4,74,0.2972972972972973,0.2972972972972973,0.6486486486486487
PLlmJTM4_Wg,191,194,25,410,0.4658536585365854,0.4658536585365854,0.47317073170731705
PMGsHA0VvXM,14,34,6,54,0.25925925925925924,0.25925925925925924,0.6296296296296297
POR-AY3qM0Q,98,134,16,248,0.3951612903225806,0.3951612903225806,0.5403225806451613
PQ0dXb0mT6A,11,16,6,33,0.3333333333333333,0.3333333333333333,0.48484848484848486
PTKVSK16YJk,10,33,0,43,0.23255813953488372,0.23255813953488372,0.7674418604651163
PULsaocqHls,13,51,1,65,0.2,0.2,0.7846153846153846
PVewKbRwbok,64,101,13,178,0.3595505617977528,0.3595505617977528,0.5674157303370787
PVrf7zqd05Y,13,11,0,24,0.5416666666666666,0.5416666666666666,0.4583333333333333
PVwQcUjehaw,17,24,2,43,0.3953488372093023,0.3953488372093023,0.5581395348837209
PWdqE9eKzg0,2,7,3,12,0.16666666666666666,0.16666666666666666,0.5833333333333334
PWe3hOoayS0,3,8,1,12,0.25,0.25,0.6666666666666666
PWhJSW3wktc,10,11,1,22,0.45454545454545453,0.45454545454545453,0.5
PYNloWcLB5k,12,31,0,43,0.27906976744186046,0.27906976744186046,0.7209302325581395
PYRrgeRBhoU,57,8,3,68,0.8382352941176471,0.8382352941176471,0.11764705882352941
PZU5dl8Fs1E,102,61,5,168,0.6071428571428571,0.6071428571428571,0.3630952380952381
PalZu3kXII0,8,28,2,38,0.21052631578947367,0.21052631578947367,0.7368421052631579
PawjVp0MhqU,26,36,5,67,0.3880597014925373,0.3880597014925373,0.5373134328358209
PbWDnCksk8o,26,21,4,51,0.5098039215686274,0.5098039215686274,0.4117647058823529
PboQhdy1ADM,177,79,14,270,0.6555555555555556,0.6555555555555556,0.29259259259259257
PcDF3p8ex-s,11,7,3,21,0.5238095238095238,0.5238095238095238,0.3333333333333333
PczyJlW-LNQ,10,22,3,35,0.2857142857142857,0.2857142857142857,0.6285714285714286
Pdczej817pg,191,185,41,417,0.4580335731414868,0.4580335731414868,0.44364508393285373
PeqZ655SV4A,6,23,5,34,0.17647058823529413,0.17647058823529413,0.6764705882352942
PeyzRMyPBLQ,15,38,2,55,0.2727272727272727,0.2727272727272727,0.6909090909090909
PfCsee9DG4w,18,43,4,65,0.27692307692307694,0.27692307692307694,0.6615384615384615
PfHdv1oiJmQ,17,32,3,52,0.3269230769230769,0.3269230769230769,0.6153846153846154
Pfq3dcE4Evc,84,57,5,146,0.5753424657534246,0.5753424657534246,0.3904109589041096
PgXA-9ne5Nk,5,19,3,27,0.18518518518518517,0.18518518518518517,0.7037037037037037
Ph0dLM2l1J0,214,122,16,352,0.6079545454545454,0.6079545454545454,0.3465909090909091
Ph8dFlPaozc,12,32,5,49,0.24489795918367346,0.24489795918367346,0.6530612244897959
PiO8MZPVrxE,2,18,3,23,0.08695652173913043,0.08695652173913043,0.782608695652174
PieAKhlY4oY,15,83,4,102,0.14705882352941177,0.14705882352941177,0.8137254901960784
PihYqA8GD68,4,7,0,11,0.36363636363636365,0.36363636363636365,0.6363636363636364
PjTRH8IRHAc,1,18,2,21,0.047619047619047616,0.047619047619047616,0.8571428571428571
PjYbmwRuu_k,24,25,4,53,0.4528301886792453,0.4528301886792453,0.4716981132075472
PkAdACJRILU,15,42,5,62,0.24193548387096775,0.24193548387096775,0.6774193548387096
Pkd-SOz3i8E,4,11,2,17,0.23529411764705882,0.23529411764705882,0.6470588235294118
PkoAyr95rA0,16,20,1,37,0.43243243243243246,0.43243243243243246,0.5405405405405406
PnPWxGs1vUU,5,16,0,21,0.23809523809523808,0.23809523809523808,0.7619047619047619
Pnsn8CqovOM,8,21,0,29,0.27586206896551724,0.27586206896551724,0.7241379310344828
PoJrnGZLVGw,810,2944,697,4451,0.18198157717366883,0.18198157717366883,0.6614243990114581
PoVfRF2MM3U,12,29,3,44,0.2727272727272727,0.2727272727272727,0.6590909090909091
Pp0g0O0QPI8,21,9,1,31,0.6774193548387096,0.6774193548387096,0.2903225806451613
PqBK7n9YhpQ,13,6,2,21,0.6190476190476191,0.6190476190476191,0.2857142857142857
PqplINaf7Vs,42,131,11,184,0.22826086956521738,0.22826086956521738,0.7119565217391305
Pr1VKnhVjrc,8,7,2,17,0.47058823529411764,0.47058823529411764,0.4117647058823529
PrDAX_OANw0,28,13,4,45,0.6222222222222222,0.6222222222222222,0.28888888888888886
Ps-AvCT0_6k,47,109,8,164,0.2865853658536585,0.2865853658536585,0.6646341463414634
PsJoOfnIcWw,5,12,1,18,0.2777777777777778,0.2777777777777778,0.6666666666666666
PuI5WKgLiF8,58,46,4,108,0.5370370370370371,0.5370370370370371,0.42592592592592593
Pua9CUsh6RA,2,0,0,2,1,1,0
PvVvluqY3nE,8,74,14,96,0.08333333333333333,0.08333333333333333,0.7708333333333334
Pvu8IP3G5KU,32,26,3,61,0.5245901639344263,0.5245901639344263,0.4262295081967213
PwLSxuKuuuU,2,5,2,9,0.2222222222222222,0.2222222222222222,0.5555555555555556
Pwgfwkl2ekA,54,129,9,192,0.28125,0.28125,0.671875
Py8MrN3GpFE,25,91,5,121,0.2066115702479339,0.2066115702479339,0.7520661157024794
PzvPh5bMLa4,24,30,3,57,0.42105263157894735,0.42105263157894735,0.5263157894736842
Q-4lfpWN4tM,6,14,2,22,0.2727272727272727,0.2727272727272727,0.6363636363636364
Q2eFxpCsGY0,2,15,3,20,0.1,0.1,0.75
Q3DaZ9Gu72U,47,39,8,94,0.5,0.5,0.4148936170212766
Q3pYQwz2ojE,3,12,0,15,0.2,0.2,0.8
Q4Rvy-bC6Tk,2,5,2,9,0.2222222222222222,0.2222222222222222,0.5555555555555556
Q670GJH6JkQ,6,8,1,15,0.4,0.4,0.5333333333333333
Q6Ro_Bb87zw,7,10,0,17,0.4117647058823529,0.4117647058823529,0.5882352941176471
Q7WifIQToUU,13,27,0,40,0.325,0.325,0.675
Q7ZArzm3Qpk,32,24,1,57,0.5614035087719298,0.5614035087719298,0.42105263157894735
Q9hFs73zzOI,156,111,11,278,0.5611510791366906,0.5611510791366906,0.39928057553956836
QBOLvSmKG5Q,10,32,4,46,0.21739130434782608,0.21739130434782608,0.6956521739130435
QBbyH_CXF9c,21,42,3,66,0.3181818181818182,0.3181818181818182,0.6363636363636364
QBeTewdMMdI,53,26,5,84,0.6309523809523809,0.6309523809523809,0.30952380952380953
QCMfD-nMnqo,0,7,1,8,0,0,0.875
QEs0D6_a-sg,5,12,2,19,0.2631578947368421,0.2631578947368421,0.631578947368421
QFMwwrD34Ig,0,4,0,4,0,0,1
QFeS2_uBYRQ,7,46,0,53,0.1320754716981132,0.1320754716981132,0.8679245283018868
QGK2JEQjY_U,11,4,1,16,0.6875,0.6875,0.25
QGc7XJVox9M,2,1,1,4,0.5,0.5,0.25
QIh8IMgBVZQ,2,2,0,4,0.5,0.5,0.5
QKJ59jyCFJM,14,21,3,38,0.3684210526315789,0.3684210526315789,0.5526315789473685
QKkT-zJdzhc,11,7,1,19,0.5789473684210527,0.5789473684210527,0.3684210526315789
QLAhlaq1dik,9,33,2,44,0.20454545454545456,0.20454545454545456,0.75
QNXkAy2iuzE,70,62,11,143,0.48951048951048953,0.48951048951048953,0.43356643356643354
QNiLKabEdZk,0,3,0,3,0,0,1
QNkiUSJKhSk,17,40,3,60,0.2833333333333333,0.2833333333333333,0.6666666666666666
QOPdjlnoOrU,3,11,1,15,0.2,0.2,0.7333333333333333
QPIWdx8MxZs,4,2,0,6,0.6666666666666666,0.6666666666666666,0.3333333333333333
QPXbeMe75Fk,25,38,0,63,0.3968253968253968,0.3968253968253968,0.6031746031746031
QPsOgawngEE,28,66,4,98,0.2857142857142857,0.2857142857142857,0.673469387755102
QRMTErJJ140,3,4,1,8,0.375,0.375,0.5
QS1BxMjSElM,22,28,0,50,0.44,0.44,0.56
QSNx3SEqNy0,12,6,4,22,0.5454545454545454,0.5454545454545454,0.2727272727272727
QUfcWoWUeKo,7,16,2,25,0.28,0.28,0.64
QVXX2oRXkEg,19,61,5,85,0.2235294117647059,0.2235294117647059,0.7176470588235294
QWcAlSk6ZPY,8,20,4,32,0.25,0.25,0.625
QXQAx3t-K_8,59,235,33,327,0.18042813455657492,0.18042813455657492,0.7186544342507645
QYw4SOhx010,7,42,4,53,0.1320754716981132,0.1320754716981132,0.7924528301886793
QZ7z2Wuxg9o,0,1,0,1,0,0,1
QZ9iCMShSoM,1,1,1,3,0.3333333333333333,0.3333333333333333,0.3333333333333333
QZCie_2Nons,18,7,3,28,0.6428571428571429,0.6428571428571429,0.25
QZDFGrxAtkc,3,14,1,18,0.16666666666666666,0.16666666666666666,0.7777777777777778
QZsny01Zc_w,73,42,5,120,0.6083333333333333,0.6083333333333333,0.35
Q_7PWbdUKBE,18,59,3,80,0.225,0.225,0.7375
Q_BVHs6BaIk,3,8,6,17,0.17647058823529413,0.17647058823529413,0.47058823529411764
Q_RFHzs1W6s,10,33,5,48,0.20833333333333334,0.20833333333333334,0.6875
QaU7eB4c8_8,9,5,0,14,0.6428571428571429,0.6428571428571429,0.35714285714285715
QbBzvhg_2Qk,3,12,1,16,0.1875,0.1875,0.75
QbEN5Bd1btk,559,264,56,879,0.6359499431171786,0.6359499431171786,0.3003412969283277
QbiRSPd7Q3c,15,69,3,87,0.1724137931034483,0.1724137931034483,0.7931034482758621
QbyF90VYeQ8,14,30,3,47,0.2978723404255319,0.2978723404255319,0.6382978723404256
Qce-dis6PNM,13,18,0,31,0.41935483870967744,0.41935483870967744,0.5806451612903226
QdKXu2JxQ84,24,20,1,45,0.5333333333333333,0.5333333333333333,0.4444444444444444
QdgzDWzNxuM,12,14,0,26,0.46153846153846156,0.46153846153846156,0.5384615384615384
Qe6rBcU_4SA,1,2,0,3,0.3333333333333333,0.3333333333333333,0.6666666666666666
QfHcBS3Q3WA,7,4,1,12,0.5833333333333334,0.5833333333333334,0.3333333333333333
QhVwxjPED7A,20,26,1,47,0.425531914893617,0.425531914893617,0.5531914893617021
QhmzYoA9gK0,30,24,4,58,0.5172413793103449,0.5172413793103449,0.41379310344827586
QjHUgSiTtsU,22,32,5,59,0.3728813559322034,0.3728813559322034,0.5423728813559322
QkIQNbj2wJw,14,11,2,27,0.5185185185185185,0.5185185185185185,0.4074074074074074
QkMr7SdAXGU,18,29,3,50,0.36,0.36,0.58
QkXH3vS_eKc,8,16,1,25,0.32,0.32,0.64
QkoIL-KyqHU,1,6,1,8,0.125,0.125,0.75
QmrhLg8rhgk,10,6,1,17,0.5882352941176471,0.5882352941176471,0.35294117647058826
Qn4-mgEGi3o,43,40,8,91,0.4725274725274725,0.4725274725274725,0.43956043956043955
QoSUdYpBBSk,9,14,1,24,0.375,0.375,0.5833333333333334
QoftnRvz5Bw,8,14,0,22,0.36363636363636365,0.36363636363636365,0.6363636363636364
QpS_I3GfMJ0,1,4,0,5,0.2,0.2,0.8
QqL8zULDvX0,21,14,1,36,0.5833333333333334,0.5833333333333334,0.3888888888888889
QqcBw01Eydg,11,20,3,34,0.3235294117647059,0.3235294117647059,0.5882352941176471
Qr0ElBsUSEM,19,17,3,39,0.48717948717948717,0.48717948717948717,0.4358974358974359
Qu5VkMyFh_Y,5,10,1,16,0.3125,0.3125,0.625
QuBD-vQsZB8,4,8,1,13,0.3076923076923077,0.3076923076923077,0.6153846153846154
QvDIWc-oo7I,20,9,5,34,0.5882352941176471,0.5882352941176471,0.2647058823529412
QvE_mvWZ3ZI,38,26,11,75,0.5066666666666667,0.5066666666666667,0.3466666666666667
Qw-fghc6IGA,8,11,2,21,0.38095238095238093,0.38095238095238093,0.5238095238095238
Qwes7fgHmp4,10,32,3,45,0.2222222222222222,0.2222222222222222,0.7111111111111111
Qxvkmqo8xOU,7,21,2,30,0.23333333333333334,0.23333333333333334,0.7
QyMAD9kC-do,15,22,2,39,0.38461538461538464,0.38461538461538464,0.5641025641025641
QyeSkCPKjPs,3,13,2,18,0.16666666666666666,0.16666666666666666,0.7222222222222222
QzH1kspYoJI,22,63,8,93,0.23655913978494625,0.23655913978494625,0.6774193548387096
QzPSRbIopok,5,15,0,20,0.25,0.25,0.75
R0Ey4pYem1g,17,22,2,41,0.4146341463414634,0.4146341463414634,0.5365853658536586
R0PfqI1Aqtc,12,23,2,37,0.32432432432432434,0.32432432432432434,0.6216216216216216
R4XXg-W-ioQ,22,78,7,107,0.205607476635514,0.205607476635514,0.7289719626168224
R4xUF5aTvjE,23,52,2,77,0.2987012987012987,0.2987012987012987,0.6753246753246753
R5_B3uP9a0M,2,12,0,14,0.14285714285714285,0.14285714285714285,0.8571428571428571
R5oAdvnJhP8,118,39,7,164,0.7195121951219512,0.7195121951219512,0.23780487804878048
R5uPkAh1Zys,3,14,3,20,0.15,0.15,0.7
R7Nj7C9KrJs,5,13,1,19,0.2631578947368421,0.2631578947368421,0.6842105263157895
R7ujNbW6qrM,13,49,2,64,0.203125,0.203125,0.765625
R7ylqRyayiU,16,48,5,69,0.2318840579710145,0.2318840579710145,0.6956521739130435
R9Ez5Kg2FDY,23,38,14,75,0.30666666666666664,0.30666666666666664,0.5066666666666667
RBiwjiHNgKw,28,40,4,72,0.3888888888888889,0.3888888888888889,0.5555555555555556
RCTiX72IeIQ,7,14,2,23,0.30434782608695654,0.30434782608695654,0.6086956521739131
RCijVWrgmxU,38,27,2,67,0.5671641791044776,0.5671641791044776,0.40298507462686567
RCp45Qiee1E,2,9,1,12,0.16666666666666666,0.16666666666666666,0.75
REZ9sZwSpCo,142,80,14,236,0.6016949152542372,0.6016949152542372,0.3389830508474576
RFU7L9WmjOg,17,5,5,27,0.6296296296296297,0.6296296296296297,0.18518518518518517
RFVBCIKbnJ8,6,10,1,17,0.35294117647058826,0.35294117647058826,0.5882352941176471
RG_a-FtzyUk,9,20,1,30,0.3,0.3,0.6666666666666666
RGgB82qhb0U,8,36,6,50,0.16,0.16,0.72
RHHFzzA-G7I,32,18,1,51,0.6274509803921569,0.6274509803921569,0.35294117647058826
RHsHURL8zB4,60,49,9,118,0.5084745762711864,0.5084745762711864,0.4152542372881356
RIc9ui7wUKM,33,29,2,64,0.515625,0.515625,0.453125
RJ4Iveit414,58,111,16,185,0.31351351351351353,0.31351351351351353,0.6
RLTHroaygfQ,35,127,3,165,0.21212121212121213,0.21212121212121213,0.7696969696969697
RLlexPrXMNs,30,10,4,44,0.6818181818181818,0.6818181818181818,0.22727272727272727
RN48jFh7qSM,19,39,4,62,0.3064516129032258,0.3064516129032258,0.6290322580645161
ROiHfyLt5_0,10,8,2,20,0.5,0.5,0.4
RPK3n__wAW8,6,29,1,36,0.16666666666666666,0.16666666666666666,0.8055555555555556
RRUq9Nw5msU,18,33,2,53,0.33962264150943394,0.33962264150943394,0.6226415094339622
RRr12ROpvxk,21,100,4,125,0.168,0.168,0.8
RSindg0iJr4,15,27,1,43,0.3488372093023256,0.3488372093023256,0.627906976744186
RVKv1KxC_7I,7,1,0,8,0.875,0.875,0.125
RZBq88_3zuw,33,16,1,50,0.66,0.66,0.32
R_GEEIeGbr0,126,96,19,241,0.5228215767634855,0.5228215767634855,0.3983402489626556
RcnjM_C25KE,10,44,6,60,0.16666666666666666,0.16666666666666666,0.7333333333333333
Rd595q34aYo,10,21,4,35,0.2857142857142857,0.2857142857142857,0.6
Rf3fi_-1LQ0,2,15,1,18,0.1111111111111111,0.1111111111111111,0.8333333333333334
RfOd6lTOWNM,1,1,0,2,0.5,0.5,0.5
RfWtXMpRNA0,3,2,0,5,0.6,0.6,0.4
RgEhxfo5cEo,71,119,14,204,0.3480392156862745,0.3480392156862745,0.5833333333333334
RgKXH_9VghY,8,4,0,12,0.6666666666666666,0.6666666666666666,0.3333333333333333
RgOmjtGM7hQ,15,21,2,38,0.39473684210526316,0.39473684210526316,0.5526315789473685
Rh9g3HjQbaE,8,21,1,30,0.26666666666666666,0.26666666666666666,0.7
RhIt-zRwOAw,7,17,1,25,0.28,0.28,0.68
Rhrodsvn8s4,13,64,5,82,0.15853658536585366,0.15853658536585366,0.7804878048780488
RigfEwvDx8s,41,58,7,106,0.3867924528301887,0.3867924528301887,0.5471698113207547
RjA635WWuw8,1,14,1,16,0.0625,0.0625,0.875
Rk9rHakfasI,44,49,12,105,0.41904761904761906,0.41904761904761906,0.4666666666666667
Rkm5XEd3xys,2,8,1,11,0.18181818181818182,0.18181818181818182,0.7272727272727273
RlP1DBtx8vk,21,84,6,111,0.1891891891891892,0.1891891891891892,0.7567567567567568
RmLhyIX7s30,16,39,1,56,0.2857142857142857,0.2857142857142857,0.6964285714285714
Rn1v8vvBQfQ,8,17,3,28,0.2857142857142857,0.2857142857142857,0.6071428571428571
Rnbr0P2mqFs,5,15,5,25,0.2,0.2,0.6
Rnki-1g2UZk,14,35,2,51,0.27450980392156865,0.27450980392156865,0.6862745098039216
RnvmS7UhHwc,28,74,6,108,0.25925925925925924,0.25925925925925924,0.6851851851851852
RprIAe4M-wA,15,44,2,61,0.2459016393442623,0.2459016393442623,0.7213114754098361
Rq-BtH7pGIg,3,5,2,10,0.3,0.3,0.5
RqrGa0iXSzs,28,21,6,55,0.509090909090909,0.509090909090909,0.38181818181818183
RqxylaAmSls,2,1,0,3,0.6666666666666666,0.6666666666666666,0.3333333333333333
Rr2hEtROT9o,10,12,0,22,0.45454545454545453,0.45454545454545453,0.5454545454545454
RrUP4b1uEHE,6,10,0,16,0.375,0.375,0.625
RtudukymBAk,19,66,7,92,0.20652173913043478,0.20652173913043478,0.717391304347826
RwxzATshLoc,24,30,3,57,0.42105263157894735,0.42105263157894735,0.5263157894736842
Rwz6HZuxNMs,15,2,0,17,0.8823529411764706,0.8823529411764706,0.11764705882352941
RxqR6AhttNQ,29,22,1,52,0.5576923076923077,0.5576923076923077,0.4230769230769231
S-7nbgSGGk8,35,32,7,74,0.47297297297297297,0.47297297297297297,0.43243243243243246
S0C6jMZ6VVo,6,26,3,35,0.17142857142857143,0.17142857142857143,0.7428571428571429
S0ugZSosdz8,3,17,3,23,0.13043478260869565,0.13043478260869565,0.7391304347826086
S11mDj3Pjps,0,3,0,3,0,0,1
S16Um40e5MQ,0,2,1,3,0,0,0.6666666666666666
S1YXQ-LqqLY,7,24,3,34,0.20588235294117646,0.20588235294117646,0.7058823529411765
S36OmBUb4dc,6,13,0,19,0.3157894736842105,0.3157894736842105,0.6842105263157895
S3Wjph795Xo,4,8,2,14,0.2857142857142857,0.2857142857142857,0.5714285714285714
S43bOoSpYeI,7,22,1,30,0.23333333333333334,0.23333333333333334,0.7333333333333333
S4Wm1k36cwQ,14,33,3,50,0.28,0.28,0.66
S5NqA0lI3xI,92,42,12,146,0.6301369863013698,0.6301369863013698,0.2876712328767123
S7SpaUKYHSI,32,67,3,102,0.3137254901960784,0.3137254901960784,0.6568627450980392
S7e4SOsxDxQ,5,16,1,22,0.22727272727272727,0.22727272727272727,0.7272727272727273
S8i063txWdA,1,0,0,1,1,1,0
S9fbK7qVPUY,28,122,11,161,0.17391304347826086,0.17391304347826086,0.7577639751552795
SA_oh0vqpUM,109,151,17,277,0.3935018050541516,0.3935018050541516,0.5451263537906137
SAnSoPzWOTo,22,46,5,73,0.3013698630136986,0.3013698630136986,0.6301369863013698
SAuxUW2UNPg,80,39,13,132,0.6060606060606061,0.6060606060606061,0.29545454545454547
SB9l6EDyut4,20,121,7,148,0.13513513513513514,0.13513513513513514,0.8175675675675675
SBS-kTfIx2E,13,19,4,36,0.3611111111111111,0.3611111111111111,0.5277777777777778
SBmkbv479hY,79,80,13,172,0.45930232558139533,0.45930232558139533,0.46511627906976744
SDs1oYkQU7U,54,155,16,225,0.24,0.24,0.6888888888888889
SECjIMbWX5E,14,16,1,31,0.45161290322580644,0.45161290322580644,0.5161290322580645
SEoZnwtsjbM,24,17,0,41,0.5853658536585366,0.5853658536585366,0.4146341463414634
SErqH9piu4E,7,3,0,10,0.7,0.7,0.3
SF89rc_C_RI,1,3,0,4,0.25,0.25,0.75
SF8m3MOu6dk,13,10,1,24,0.5416666666666666,0.5416666666666666,0.4166666666666667
SG-IIVh8Mps,7,8,0,15,0.4666666666666667,0.4666666666666667,0.5333333333333333
SIwY5LzUQqU,29,31,6,66,0.4393939393939394,0.4393939393939394,0.4696969696969697
SJ62A8zwTwg,7,4,0,11,0.6363636363636364,0.6363636363636364,0.36363636363636365
SJKImX_AAjw,58,42,1,101,0.5742574257425742,0.5742574257425742,0.4158415841584158
SK2rpPTKBEM,2,1,0,3,0.6666666666666666,0.6666666666666666,0.3333333333333333
SL9OGwGLW8A,17,22,0,39,0.4358974358974359,0.4358974358974359,0.5641025641025641
SLs2jj5nxTo,7,1,0,8,0.875,0.875,0.125
SMyt74VUAeo,8,30,5,43,0.18604651162790697,0.18604651162790697,0.6976744186046512
SNxzHbMjEPA,4,17,0,21,0.19047619047619047,0.19047619047619047,0.8095238095238095
SPAf6XRgWDQ,6,29,1,36,0.16666666666666666,0.16666666666666666,0.8055555555555556
SPCJxKi0H7Q,17,7,4,28,0.6071428571428571,0.6071428571428571,0.25
SPGMGOm46MA,13,43,2,58,0.22413793103448276,0.22413793103448276,0.7413793103448276
SPHs328hXlc,13,64,1,78,0.16666666666666666,0.16666666666666666,0.8205128205128205
SPyiOV7xiNc,20,20,3,43,0.46511627906976744,0.46511627906976744,0.46511627906976744
SQ79sfNlQJE,7,23,3,33,0.21212121212121213,0.21212121212121213,0.696969696969697
SRkY0tzl8S0,3,16,1,20,0.15,0.15,0.8
SUCE96Fx224,21,71,12,104,0.20192307692307693,0.20192307692307693,0.6826923076923077
SUUhlVyrGgc,4,9,0,13,0.3076923076923077,0.3076923076923077,0.6923076923076923
SUa6wx6LugQ,10,22,6,38,0.2631578947368421,0.2631578947368421,0.5789473684210527
SVbSdX9vHwU,30,125,15,170,0.17647058823529413,0.17647058823529413,0.7352941176470589
SW6uFtaoVdE,4,8,0,12,0.3333333333333333,0.3333333333333333,0.6666666666666666
SWTDmgjDVaI,26,91,3,120,0.21666666666666667,0.21666666666666667,0.7583333333333333
SXVG0uvSKNA,12,41,4,57,0.21052631578947367,0.21052631578947367,0.7192982456140351
SXW7i5C_zK0,14,43,2,59,0.23728813559322035,0.23728813559322035,0.7288135593220338
SZI0a7sU8r0,21,42,8,71,0.29577464788732394,0.29577464788732394,0.5915492957746479
SZR1NBe8EN0,15,5,0,20,0.75,0.75,0.25
SZycM9fJ2ls,27,19,2,48,0.5625,0.5625,0.3958333333333333
S_njRtlCeaQ,19,58,2,79,0.24050632911392406,0.24050632911392406,0.7341772151898734
SdSN7Ba5HDY,11,71,1,83,0.13253012048192772,0.13253012048192772,0.8554216867469879
SeS-UJjGQA4,13,26,5,44,0.29545454545454547,0.29545454545454547,0.5909090909090909
Sg3EBcdUw1Y,3,23,0,26,0.11538461538461539,0.11538461538461539,0.8846153846153846
Sh7FOssoOSM,28,25,4,57,0.49122807017543857,0.49122807017543857,0.43859649122807015
Sho8fcNbzuk,12,9,1,22,0.5454545454545454,0.5454545454545454,0.4090909090909091
SiNxLCNMiLw,71,54,5,130,0.5461538461538461,0.5461538461538461,0.4153846153846154
SifdDdeKfLs,2,6,0,8,0.25,0.25,0.75
SjutdXssXPc,42,28,4,74,0.5675675675675675,0.5675675675675675,0.3783783783783784
SlrQyYTJPao,7,20,1,28,0.25,0.25,0.7142857142857143
Smdjf80zg2c,19,32,5,56,0.3392857142857143,0.3392857142857143,0.5714285714285714
SoNowAv8dfQ,102,88,10,200,0.51,0.51,0.44
SoyYqBfy0hE,2,16,1,19,0.10526315789473684,0.10526315789473684,0.8421052631578947
SpHiynDRfhc,4,11,2,17,0.23529411764705882,0.23529411764705882,0.6470588235294118
Sr3UqlQ6P_Q,171,218,16,405,0.4222222222222222,0.4222222222222222,0.5382716049382716
SsrFUFQRaQU,14,51,3,68,0.20588235294117646,0.20588235294117646,0.75
StD8e2qlsPs,35,91,7,133,0.2631578947368421,0.2631578947368421,0.6842105263157895
SxFNxPDOOGA,2,22,1,25,0.08,0.08,0.88
SxI1vQNbaz4,1,4,0,5,0.2,0.2,0.8
SxMADfDqYDg,19,59,3,81,0.2345679012345679,0.2345679012345679,0.7283950617283951
SyKWrBdRSvQ,1,1,0,2,0.5,0.5,0.5
T-LiZxapBQ8,186,203,17,406,0.458128078817734,0.458128078817734,0.5
T07WXwhCyGU,113,357,35,505,0.22376237623762377,0.22376237623762377,0.7069306930693069
T36rLuof70c,60,96,7,163,0.36809815950920244,0.36809815950920244,0.588957055214724
T4qlBHrtYNw,19,40,1,60,0.31666666666666665,0.31666666666666665,0.6666666666666666
T5aMOhzs4T8,9,38,9,56,0.16071428571428573,0.16071428571428573,0.6785714285714286
T8lVs-VEjt0,49,398,12,459,0.10675381263616558,0.10675381263616558,0.8671023965141612
T9tjThNSaZU,81,72,14,167,0.48502994011976047,0.48502994011976047,0.4311377245508982
TBxpFkYnCCk,10,81,0,91,0.10989010989010989,0.10989010989010989,0.8901098901098901
TFpIf9cIb6E,14,18,4,36,0.3888888888888889,0.3888888888888889,0.5
TH3s3KnSwug,194,95,10,299,0.6488294314381271,0.6488294314381271,0.3177257525083612
THpF6lG7ENo,23,120,18,161,0.14285714285714285,0.14285714285714285,0.7453416149068323
THw3oT_PeAQ,10,16,4,30,0.3333333333333333,0.3333333333333333,0.5333333333333333
TIZaea5TM6A,18,16,5,39,0.46153846153846156,0.46153846153846156,0.41025641025641024
TJIjOSB7GZA,3,21,1,25,0.12,0.12,0.84
TJLTSaf-GWo,3,2,1,6,0.5,0.5,0.3333333333333333
TJkdFN_aICA,1,0,0,1,1,1,0
TKaPumOXpW8,22,30,7,59,0.3728813559322034,0.3728813559322034,0.5084745762711864
TKfhh97A4vM,12,4,0,16,0.75,0.75,0.25
TMFViHJMz2Y,154,211,25,390,0.39487179487179486,0.39487179487179486,0.541025641025641
TMS4brP2kT0,1,11,1,13,0.07692307692307693,0.07692307692307693,0.8461538461538461
TMU_6VPRlqM,9,13,1,23,0.391304347826087,0.391304347826087,0.5652173913043478
TONwq8b_drs,1,3,2,6,0.16666666666666666,0.16666666666666666,0.5
TPSCgQOVrpU,29,42,2,73,0.3972602739726027,0.3972602739726027,0.5753424657534246
TPXzux-epXU,1030,3368,491,4889,0.21067703006749847,0.21067703006749847,0.6888934342401309
TQRzpSDJ3Hw,8,17,3,28,0.2857142857142857,0.2857142857142857,0.6071428571428571
TRAvcWtEiPQ,2,4,0,6,0.3333333333333333,0.3333333333333333,0.6666666666666666
TRu7b1hT9m0,7,22,2,31,0.22580645161290322,0.22580645161290322,0.7096774193548387
TStJmUrXNI0,24,35,3,62,0.3870967741935484,0.3870967741935484,0.5645161290322581
TTqk2qw_wo0,29,106,17,152,0.19078947368421054,0.19078947368421054,0.6973684210526315
TV--71znTAw,6,12,0,18,0.3333333333333333,0.3333333333333333,0.6666666666666666
TWE6oCWPHHE,5,27,5,37,0.13513513513513514,0.13513513513513514,0.7297297297297297
TWdO7pJ6ax0,2,10,0,12,0.16666666666666666,0.16666666666666666,0.8333333333333334
TWuZkySd3g4,7,25,0,32,0.21875,0.21875,0.78125
TXJEv3j0OBs,126,417,71,614,0.20521172638436483,0.20521172638436483,0.6791530944625407
TYP355HDaXw,12,57,0,69,0.17391304347826086,0.17391304347826086,0.8260869565217391
TYefwYJCOww,5,12,1,18,0.2777777777777778,0.2777777777777778,0.6666666666666666
T_kbl7WjXhk,10,59,10,79,0.12658227848101267,0.12658227848101267,0.7468354430379747
Ta5y2QGcsyo,15,2,1,18,0.8333333333333334,0.8333333333333334,0.1111111111111111
Tam9X8VykHQ,16,21,4,41,0.3902439024390244,0.3902439024390244,0.5121951219512195
TdeqbFlTvpI,14,61,7,82,0.17073170731707318,0.17073170731707318,0.7439024390243902
TdpSkGAhyMs,6,20,4,30,0.2,0.2,0.6666666666666666
Tf4lRf2YFVA,12,20,1,33,0.36363636363636365,0.36363636363636365,0.6060606060606061
TfYG60ULumU,77,55,8,140,0.55,0.55,0.39285714285714285
Tfmdfzsiuwg,42,70,7,119,0.35294117647058826,0.35294117647058826,0.5882352941176471
Tib2gJz_wXU,5,8,2,15,0.3333333333333333,0.3333333333333333,0.5333333333333333
TicHofYmvZY,5,16,0,21,0.23809523809523808,0.23809523809523808,0.7619047619047619
TieuEjJuhik,5,15,3,23,0.21739130434782608,0.21739130434782608,0.6521739130434783
TjSkRA0Nv1o,15,20,5,40,0.375,0.375,0.5
TkCoVKH7P50,14,22,0,36,0.3888888888888889,0.3888888888888889,0.6111111111111112
TkKg7N4q43s,120,93,8,221,0.5429864253393665,0.5429864253393665,0.42081447963800905
TkOBs6Wouik,13,23,3,39,0.3333333333333333,0.3333333333333333,0.5897435897435898
TmVmm_7Oza0,258,677,93,1028,0.2509727626459144,0.2509727626459144,0.6585603112840467
Tmk9eUFiTo0,4,11,1,16,0.25,0.25,0.6875
Tn6ASehU6jc,11,17,3,31,0.3548387096774194,0.3548387096774194,0.5483870967741935
TnEouD26bbU,191,302,31,524,0.36450381679389315,0.36450381679389315,0.5763358778625954
ToESOtZ1Wf8,9,22,6,37,0.24324324324324326,0.24324324324324326,0.5945945945945946
Tp-PfQtvOcs,23,101,10,134,0.17164179104477612,0.17164179104477612,0.753731343283582
Tp78fD36vBg,34,39,4,77,0.44155844155844154,0.44155844155844154,0.5064935064935064
TpJMFO3qUek,40,264,15,319,0.12539184952978055,0.12539184952978055,0.8275862068965517
TqW_q1vhS6Y,64,43,17,124,0.5161290322580645,0.5161290322580645,0.3467741935483871
TrkyqVVr5mI,9,6,1,16,0.5625,0.5625,0.375
TsMRuM5vDQc,2,11,0,13,0.15384615384615385,0.15384615384615385,0.8461538461538461
Tsa2dSOqODw,33,3,0,36,0.9166666666666666,0.9166666666666666,0.08333333333333333
Tt7vThEYcnY,3,0,0,3,1,1,0
TtskBAaGOu4,6,7,1,14,0.42857142857142855,0.42857142857142855,0.5
TwXmhiQsd7s,23,33,3,59,0.3898305084745763,0.3898305084745763,0.559322033898305
TwxdoblS8Es,11,15,3,29,0.3793103448275862,0.3793103448275862,0.5172413793103449
TxCkYkTk9GQ,53,66,4,123,0.43089430894308944,0.43089430894308944,0.5365853658536586
TyPKm1C16VM,26,20,2,48,0.5416666666666666,0.5416666666666666,0.4166666666666667
TyXrroCKzi4,5,18,1,24,0.20833333333333334,0.20833333333333334,0.75
TydwDu1Q3_g,11,53,1,65,0.16923076923076924,0.16923076923076924,0.8153846153846154
Tz1eQD6jTYo,52,61,10,123,0.42276422764227645,0.42276422764227645,0.4959349593495935
U-s8LH7AHYE,92,55,11,158,0.5822784810126582,0.5822784810126582,0.34810126582278483
U0I0QElGSx4,6,15,0,21,0.2857142857142857,0.2857142857142857,0.7142857142857143
U18DZ4LivBw,6,21,1,28,0.21428571428571427,0.21428571428571427,0.75
U1bGZSAf9tg,7,27,2,36,0.19444444444444445,0.19444444444444445,0.75
U2qOZs0CKxk,53,104,11,168,0.31547619047619047,0.31547619047619047,0.6190476190476191
U3f5sU-nVRQ,45,92,7,144,0.3125,0.3125,0.6388888888888888
U6f86IX9vz0,408,1304,211,1923,0.21216848673946959,0.21216848673946959,0.6781071242849714
U7e9oPnHlrE,32,22,1,55,0.5818181818181818,0.5818181818181818,0.4
U8E1sE5b4MI,27,127,8,162,0.16666666666666666,0.16666666666666666,0.7839506172839507
U8dPYjz2P-o,11,24,4,39,0.28205128205128205,0.28205128205128205,0.6153846153846154
U8dhqPdoU2M,9,15,3,27,0.3333333333333333,0.3333333333333333,0.5555555555555556
UCnJihalcBI,5,15,2,22,0.22727272727272727,0.22727272727272727,0.6818181818181818
UD_Zp-HO7M4,14,16,5,35,0.4,0.4,0.45714285714285713
UDa4JeBeV5I,13,21,4,38,0.34210526315789475,0.34210526315789475,0.5526315789473685
UFF4ZRrsUC4,37,95,9,141,0.2624113475177305,0.2624113475177305,0.6737588652482269
UFParREoCmc,31,78,6,115,0.26956521739130435,0.26956521739130435,0.6782608695652174
UJ9IxYVAuo4,12,51,8,71,0.16901408450704225,0.16901408450704225,0.7183098591549296
UKQ9vkSTBlo,6,0,1,7,0.8571428571428571,0.8571428571428571,0
UKziFX66kQY,2,10,1,13,0.15384615384615385,0.15384615384615385,0.7692307692307693
UMsHHBciE4o,1,6,0,7,0.14285714285714285,0.14285714285714285,0.8571428571428571
UNqDPj_0EXw,11,32,2,45,0.24444444444444444,0.24444444444444444,0.7111111111111111
UPAKTti6Qk4,5,3,1,9,0.5555555555555556,0.5555555555555556,0.3333333333333333
UPEseqySamo,4,8,1,13,0.3076923076923077,0.3076923076923077,0.6153846153846154
UPnRupdE1Nw,22,27,1,50,0.44,0.44,0.54
URvOr9Uf0jk,24,34,7,65,0.36923076923076925,0.36923076923076925,0.5230769230769231
US-_q791-RQ,9,47,4,60,0.15,0.15,0.7833333333333333
US8COScbpL0,18,65,7,90,0.2,0.2,0.7222222222222222
USlTk8Joh8Q,122,224,36,382,0.3193717277486911,0.3193717277486911,0.5863874345549738
USsK_SYTfDs,6,10,1,17,0.35294117647058826,0.35294117647058826,0.5882352941176471
UT1AX1uJALA,5,8,1,14,0.35714285714285715,0.35714285714285715,0.5714285714285714
UU0o-UKumVI,21,19,2,42,0.5,0.5,0.4523809523809524
UVTskai8_hk,33,148,21,202,0.16336633663366337,0.16336633663366337,0.7326732673267327
UVURrRgNfHM,27,38,1,66,0.4090909090909091,0.4090909090909091,0.5757575757575758
UX7EgvLmDuc,11,14,5,30,0.36666666666666664,0.36666666666666664,0.4666666666666667
UYRb5nRpnMw,1,5,1,7,0.14285714285714285,0.14285714285714285,0.7142857142857143
UYmZXft_eI0,7,10,0,17,0.4117647058823529,0.4117647058823529,0.5882352941176471
U_FFF6ms0Dw,0,1,1,2,0,0,0.5
UaT3sYt7CvQ,7,14,5,26,0.2692307692307692,0.2692307692307692,0.5384615384615384
UaiW4rkkhYM,7,17,7,31,0.22580645161290322,0.22580645161290322,0.5483870967741935
Uf2dUCEVUcQ,16,38,12,66,0.24242424242424243,0.24242424242424243,0.5757575757575758
Uf3B6P9x-x4,2,2,4,8,0.25,0.25,0.25
UfEXIMVVCV0,20,7,1,28,0.7142857142857143,0.7142857142857143,0.25
UfGIu0vGEuM,286,138,15,439,0.6514806378132119,0.6514806378132119,0.3143507972665148
UgFuwG4lCg4,11,15,4,30,0.36666666666666664,0.36666666666666664,0.5
UhR2PYKSRrQ,9,11,4,24,0.375,0.375,0.4583333333333333
UhiMFEsYPvA,14,35,3,52,0.2692307692307692,0.2692307692307692,0.6730769230769231
UiabEpYtzYQ,5,20,4,29,0.1724137931034483,0.1724137931034483,0.6896551724137931
Uk0QOgInj60,9,23,3,35,0.2571428571428571,0.2571428571428571,0.6571428571428571
UlEL7dSoyFA,20,71,7,98,0.20408163265306123,0.20408163265306123,0.7244897959183674
Ulcrj1Car-E,10,15,3,28,0.35714285714285715,0.35714285714285715,0.5357142857142857
Umf61QDnd5I,13,5,0,18,0.7222222222222222,0.7222222222222222,0.2777777777777778
Uo9BizBx_Ks,77,43,7,127,0.6062992125984252,0.6062992125984252,0.33858267716535434
Uo9QKW3IjRE,13,12,4,29,0.4482758620689655,0.4482758620689655,0.41379310344827586
UoFTr-0htkQ,4,37,0,41,0.0975609756097561,0.0975609756097561,0.9024390243902439
UouaL1VBaTY,6,34,0,40,0.15,0.15,0.85
Ups7-mRbRFA,1,3,0,4,0.25,0.25,0.75
UsqPmTFTV9w,4,10,4,18,0.2222222222222222,0.2222222222222222,0.5555555555555556
Uu-0iC8Dy0M,17,60,14,91,0.18681318681318682,0.18681318681318682,0.6593406593406593
UvAlmoP4aUo,17,27,2,46,0.3695652173913043,0.3695652173913043,0.5869565217391305
UvoaOMuhS1s,8,18,1,27,0.2962962962962963,0.2962962962962963,0.6666666666666666
UxXz_TYU--c,53,15,1,69,0.7681159420289855,0.7681159420289855,0.21739130434782608
UyCyoBed9SI,3,8,1,12,0.25,0.25,0.6666666666666666
UzmygQhuF_o,49,262,46,357,0.13725490196078433,0.13725490196078433,0.7338935574229691
UznJtmpPIvc,32,152,11,195,0.1641025641025641,0.1641025641025641,0.7794871794871795
V0hUBvzGf-8,70,40,5,115,0.6086956521739131,0.6086956521739131,0.34782608695652173
V3G6zfnPDmU,8,13,1,22,0.36363636363636365,0.36363636363636365,0.5909090909090909
V3YgNieMx6Y,9,4,1,14,0.6428571428571429,0.6428571428571429,0.2857142857142857
V3xBRxolIFc,18,87,4,109,0.1651376146788991,0.1651376146788991,0.7981651376146789
V4ZqY8c9hys,47,46,10,103,0.4563106796116505,0.4563106796116505,0.44660194174757284
V50xRYM8SUE,28,44,1,73,0.3835616438356164,0.3835616438356164,0.6027397260273972
V5opzK-Pqt0,15,19,4,38,0.39473684210526316,0.39473684210526316,0.5
V6DOUWn-FOA,14,9,1,24,0.5833333333333334,0.5833333333333334,0.375
V79JIeaym0k,6,7,1,14,0.42857142857142855,0.42857142857142855,0.5
V7A0_jBCcqU,5,29,3,37,0.13513513513513514,0.13513513513513514,0.7837837837837838
V8EZ1WCWc9o,2,14,1,17,0.11764705882352941,0.11764705882352941,0.8235294117647058
V8b-kYt0cVg,29,101,10,140,0.20714285714285716,0.20714285714285716,0.7214285714285714
VAIiyEO2I4U,157,167,20,344,0.4563953488372093,0.4563953488372093,0.48546511627906974
VBI4bz2dzyo,14,37,7,58,0.2413793103448276,0.2413793103448276,0.6379310344827587
VBjl-5ib7wo,8,36,4,48,0.16666666666666666,0.16666666666666666,0.75
VC4Vixa88SM,8,6,2,16,0.5,0.5,0.375
VC9VHIAp7sA,9,30,3,42,0.21428571428571427,0.21428571428571427,0.7142857142857143
VEV8bd2mILg,14,2,2,18,0.7777777777777778,0.7777777777777778,0.1111111111111111
VFIVITN11IY,81,32,2,115,0.7043478260869566,0.7043478260869566,0.2782608695652174
VG58jHLov7Q,26,133,6,165,0.15757575757575756,0.15757575757575756,0.806060606060606
VGDoLN5Q2vY,10,17,2,29,0.3448275862068966,0.3448275862068966,0.5862068965517241
VGUt8rM0vs8,12,15,3,30,0.4,0.4,0.5
VGbmMfoDF1M,11,11,4,26,0.4230769230769231,0.4230769230769231,0.4230769230769231
VGq5BR7_ZJY,3,8,1,12,0.25,0.25,0.6666666666666666
VH6cxvwinOk,30,29,2,61,0.4918032786885246,0.4918032786885246,0.47540983606557374
VHGNtuPMnvk,0,5,0,5,0,0,1
VIpBcI2BBAM,663,260,66,989,0.6703741152679474,0.6703741152679474,0.26289180990899896
VJm-CqQeZC4,69,117,18,204,0.3382352941176471,0.3382352941176471,0.5735294117647058
VKJvmmhLHWE,4,6,0,10,0.4,0.4,0.6
VLDhBTR66MQ,40,146,15,201,0.19900497512437812,0.19900497512437812,0.7263681592039801
VLkWl3Mf0ls,46,184,7,237,0.1940928270042194,0.1940928270042194,0.7763713080168776
VMjDAVXK4Z4,5,4,0,9,0.5555555555555556,0.5555555555555556,0.4444444444444444
VNHfGD3EJz0,4,16,2,22,0.18181818181818182,0.18181818181818182,0.7272727272727273
VNpPGbaCwK8,38,66,4,108,0.35185185185185186,0.35185185185185186,0.6111111111111112
VOF_kBg5174,4,10,0,14,0.2857142857142857,0.2857142857142857,0.7142857142857143
VP7jUfCuLiI,11,13,3,27,0.4074074074074074,0.4074074074074074,0.48148148148148145
VPPfzgpa-n0,139,634,128,901,0.15427302996670367,0.15427302996670367,0.7036625971143174
VQeGDz3mPms,11,5,1,17,0.6470588235294118,0.6470588235294118,0.29411764705882354
VRGRrn_9pcc,3,7,1,11,0.2727272727272727,0.2727272727272727,0.6363636363636364
VRPQEb_vkDo,42,32,2,76,0.5526315789473685,0.5526315789473685,0.42105263157894735
VRc9Mg0YLFw,9,7,1,17,0.5294117647058824,0.5294117647058824,0.4117647058823529
VRliaCho5ZE,8,6,0,14,0.5714285714285714,0.5714285714285714,0.42857142857142855
VSKNQOwuQA4,12,17,2,31,0.3870967741935484,0.3870967741935484,0.5483870967741935
VUQ87MsX84Y,9,14,1,24,0.375,0.375,0.5833333333333334
VWUDNjyNdMU,14,8,0,22,0.6363636363636364,0.6363636363636364,0.36363636363636365
VWqODGUj7Jc,66,356,42,464,0.14224137931034483,0.14224137931034483,0.7672413793103449
VXWxAY1_RGc,13,13,2,28,0.4642857142857143,0.4642857142857143,0.4642857142857143
VX_VhzsAzb8,9,22,3,34,0.2647058823529412,0.2647058823529412,0.6470588235294118
VXpGeBfhWKA,19,68,3,90,0.2111111111111111,0.2111111111111111,0.7555555555555555
VYT2HF833xY,10,20,0,30,0.3333333333333333,0.3333333333333333,0.6666666666666666
VZKNTq_Jx6Y,1,18,2,21,0.047619047619047616,0.047619047619047616,0.8571428571428571
VZQLMWjRweU,17,81,6,104,0.16346153846153846,0.16346153846153846,0.7788461538461539
Va82kvDLP0o,450,640,220,1310,0.3435114503816794,0.3435114503816794,0.48854961832061067
VeC1JWvw544,20,41,7,68,0.29411764705882354,0.29411764705882354,0.6029411764705882
VeNaq2xVR14,22,55,4,81,0.2716049382716049,0.2716049382716049,0.6790123456790124
VemoweXVBbI,9,30,3,42,0.21428571428571427,0.21428571428571427,0.7142857142857143
Vf3cf7aPo3o,2,22,3,27,0.07407407407407407,0.07407407407407407,0.8148148148148148
VfDNTCKxJn0,9,29,1,39,0.23076923076923078,0.23076923076923078,0.7435897435897436
Vg8uT9bBSs8,16,16,2,34,0.47058823529411764,0.47058823529411764,0.47058823529411764
VgRg83WNrtU,4,18,4,26,0.15384615384615385,0.15384615384615385,0.6923076923076923
VhEbTUvyzn8,18,63,8,89,0.20224719101123595,0.20224719101123595,0.7078651685393258
VhR-5XQ8SBk,3,3,2,8,0.375,0.375,0.375
ViDhDSk6oFo,7,27,1,35,0.2,0.2,0.7714285714285715
VjJM9RM9vCQ,21,70,2,93,0.22580645161290322,0.22580645161290322,0.7526881720430108
VjPq4tNwwuY,483,770,99,1352,0.3572485207100592,0.3572485207100592,0.5695266272189349
VkaqjkBrX9M,8,24,0,32,0.25,0.25,0.75
Vlsn2dYO5cc,5,7,1,13,0.38461538461538464,0.38461538461538464,0.5384615384615384
VmV2fsp7jxQ,22,30,0,52,0.4230769230769231,0.4230769230769231,0.5769230769230769
VmYg8hiMgO8,2,27,0,29,0.06896551724137931,0.06896551724137931,0.9310344827586207
Vmgd-l9opOs,50,55,8,113,0.4424778761061947,0.4424778761061947,0.48672566371681414
VnsmmWMNlSw,79,139,6,224,0.35267857142857145,0.35267857142857145,0.6205357142857143
VpA7H7UDIYc,20,31,4,55,0.36363636363636365,0.36363636363636365,0.5636363636363636
Vq2L8vHXs6M,5,28,4,37,0.13513513513513514,0.13513513513513514,0.7567567567567568
Vqbu6-iYsYM,63,63,12,138,0.45652173913043476,0.45652173913043476,0.45652173913043476
VsB9hL65-tk,21,30,6,57,0.3684210526315789,0.3684210526315789,0.5263157894736842
VsbTrX5hkSE,3,14,3,20,0.15,0.15,0.7
VsiVA8_CUJ4,11,6,1,18,0.6111111111111112,0.6111111111111112,0.3333333333333333
Vw0lEJHN-Lg,26,25,3,54,0.48148148148148145,0.48148148148148145,0.46296296296296297
Vy3gyZKv2O8,11,3,1,15,0.7333333333333333,0.7333333333333333,0.2
Vywj7ktVz1M,0,4,0,4,0,0,1
Vz7hgHJvpxY,6,91,1,98,0.061224489795918366,0.061224489795918366,0.9285714285714286
W09-slRCi28,16,87,5,108,0.14814814814814814,0.14814814814814814,0.8055555555555556
W1U8s20Bd7U,95,135,6,236,0.4025423728813559,0.4025423728813559,0.5720338983050848
W3YqbJWf4s4,3,8,4,15,0.2,0.2,0.5333333333333333
W453oIGD1S8,4,8,0,12,0.3333333333333333,0.3333333333333333,0.6666666666666666
W45POEh05us,3,14,2,19,0.15789473684210525,0.15789473684210525,0.7368421052631579
W50LP3viCOg,3,2,0,5,0.6,0.6,0.4
W69dZFjsvoQ,14,59,2,75,0.18666666666666668,0.18666666666666668,0.7866666666666666
W8wREeijRpI,127,270,37,434,0.2926267281105991,0.2926267281105991,0.6221198156682027
WApNXVoJjJQ,47,142,23,212,0.22169811320754718,0.22169811320754718,0.6698113207547169
WCnB3kRsHrQ,15,14,1,30,0.5,0.5,0.4666666666666667
WD3Smfa_TP0,11,20,2,33,0.3333333333333333,0.3333333333333333,0.6060606060606061
WDiCNIa0C4g,4,2,0,6,0.6666666666666666,0.6666666666666666,0.3333333333333333
WGJuFSQmU2I,3,17,2,22,0.13636363636363635,0.13636363636363635,0.7727272727272727
WGYTObQFQHo,38,130,10,178,0.21348314606741572,0.21348314606741572,0.7303370786516854
WGzA3pdzKAE,16,21,5,42,0.38095238095238093,0.38095238095238093,0.5
WHkkl4_qZlQ,14,47,8,69,0.2028985507246377,0.2028985507246377,0.6811594202898551
WJ6Ei1AxK10,19,48,2,69,0.2753623188405797,0.2753623188405797,0.6956521739130435
WKOe7kbnc6U,7,12,1,20,0.35,0.35,0.6
WL0jtxpauCA,6,16,1,23,0.2608695652173913,0.2608695652173913,0.6956521739130435
WLRD9vIGaz8,8,24,1,33,0.24242424242424243,0.24242424242424243,0.7272727272727273
WL_SactWZsE,32,41,3,76,0.42105263157894735,0.42105263157894735,0.5394736842105263
WLdOMIow2M0,10,55,9,74,0.13513513513513514,0.13513513513513514,0.7432432432432432
WLmJTsLokiM,36,40,5,81,0.4444444444444444,0.4444444444444444,0.49382716049382713
WMukGLQ1GlM,4,6,1,11,0.36363636363636365,0.36363636363636365,0.5454545454545454
WNdr7bjv4nY,5,17,4,26,0.19230769230769232,0.19230769230769232,0.6538461538461539
WOBApNtlrTY,3,19,1,23,0.13043478260869565,0.13043478260869565,0.8260869565217391
WOfQ1BK1mFQ,14,17,5,36,0.3888888888888889,0.3888888888888889,0.4722222222222222
WPEj9Fm261U,11,12,4,27,0.4074074074074074,0.4074074074074074,0.4444444444444444
WPUC129KY3I,102,294,42,438,0.2328767123287671,0.2328767123287671,0.6712328767123288
WPk0Zof8jrc,19,32,3,54,0.35185185185185186,0.35185185185185186,0.5925925925925926
WQRnqclZMUY,39,119,18,176,0.2215909090909091,0.2215909090909091,0.6761363636363636
WR4czzTwYL8,30,67,11,108,0.2777777777777778,0.2777777777777778,0.6203703703703703
WRQ3ONLwmvQ,6,4,3,13,0.46153846153846156,0.46153846153846156,0.3076923076923077
WRxIrDPadqQ,9,61,4,74,0.12162162162162163,0.12162162162162163,0.8243243243243243
WTJHNBXLYM8,5,5,1,11,0.45454545454545453,0.45454545454545453,0.45454545454545453
WTTE90GTDnU,8,13,0,21,0.38095238095238093,0.38095238095238093,0.6190476190476191
WTmx3dOJrig,9,79,1,89,0.10112359550561797,0.10112359550561797,0.8876404494382022
WUVqjj4dkUk,46,165,30,241,0.1908713692946058,0.1908713692946058,0.6846473029045643
WUt3qwsRFtA,5,12,3,20,0.25,0.25,0.6
WV1ZJbYpNZk,9,13,0,22,0.4090909090909091,0.4090909090909091,0.5909090909090909
WVGhK1dMPYQ,38,53,6,97,0.3917525773195876,0.3917525773195876,0.5463917525773195
WVQT-3QTNgE,11,55,7,73,0.1506849315068493,0.1506849315068493,0.7534246575342466
WVQh1_spOA4,10,13,3,26,0.38461538461538464,0.38461538461538464,0.5
WWef4FmzqB0,6,5,0,11,0.5454545454545454,0.5454545454545454,0.45454545454545453
WWhCI5g7_Do,23,58,6,87,0.26436781609195403,0.26436781609195403,0.6666666666666666
WX1JWtispQY,15,26,2,43,0.3488372093023256,0.3488372093023256,0.6046511627906976
WYjtgrAJhWo,21,30,2,53,0.39622641509433965,0.39622641509433965,0.5660377358490566
WZ8exFdv91k,261,1157,137,1555,0.16784565916398714,0.16784565916398714,0.7440514469453376
WZzZ9tCxygY,15,41,8,64,0.234375,0.234375,0.640625
W_XZnaMnbnw,28,28,11,67,0.417910447761194,0.417910447761194,0.417910447761194
W_fgNtT2nSA,13,15,6,34,0.38235294117647056,0.38235294117647056,0.4411764705882353
WaQ7R0yiTUQ,9,25,5,39,0.23076923076923078,0.23076923076923078,0.6410256410256411
WaYUrklNojU,41,61,10,112,0.36607142857142855,0.36607142857142855,0.5446428571428571
WbfAhLsD8eQ,12,21,0,33,0.36363636363636365,0.36363636363636365,0.6363636363636364
Wd68qqn-o58,6,29,3,38,0.15789473684210525,0.15789473684210525,0.7631578947368421
WdEjP1YQ_8I,23,20,2,45,0.5111111111111111,0.5111111111111111,0.4444444444444444
WeEGGE7UE_E,32,23,5,60,0.5333333333333333,0.5333333333333333,0.38333333333333336
WgB017Tejmc,21,77,2,100,0.21,0.21,0.77
WgkwmKjTZXQ,15,15,2,32,0.46875,0.46875,0.46875
WgwZsD2lsMo,8,6,4,18,0.4444444444444444,0.4444444444444444,0.3333333333333333
Wh8rZijy5Rw,45,129,16,190,0.23684210526315788,0.23684210526315788,0.6789473684210526
Wi3bjfovgAU,27,60,5,92,0.29347826086956524,0.29347826086956524,0.6521739130434783
WiH-RjO-k0s,38,19,3,60,0.6333333333333333,0.6333333333333333,0.31666666666666665
WjTUBqoDA0Q,47,31,3,81,0.5802469135802469,0.5802469135802469,0.38271604938271603
WjnQdu2ABPs,10,6,1,17,0.5882352941176471,0.5882352941176471,0.35294117647058826
WnKnR4pqyvA,27,23,1,51,0.5294117647058824,0.5294117647058824,0.45098039215686275
WoJxX4xYKGo,1,4,0,5,0.2,0.2,0.8
WqZiMUnHv0k,11,5,0,16,0.6875,0.6875,0.3125
WqcqhSwkfss,4,21,0,25,0.16,0.16,0.84
Ws3FwFU9I2U,76,35,12,123,0.6178861788617886,0.6178861788617886,0.2845528455284553
WtEk514k5tU,5,28,1,34,0.14705882352941177,0.14705882352941177,0.8235294117647058
Wxpg048iwWY,33,127,13,173,0.1907514450867052,0.1907514450867052,0.7341040462427746
WxqGKrebGlA,1,8,1,10,0.1,0.1,0.8
Wxy_XE2T9hM,29,28,7,64,0.453125,0.453125,0.4375
Wy2bc1hQ_hg,36,67,9,112,0.32142857142857145,0.32142857142857145,0.5982142857142857
WyOhLYtFTNk,139,176,13,328,0.42378048780487804,0.42378048780487804,0.5365853658536586
Wz1GAz23i2g,27,31,6,64,0.421875,0.421875,0.484375
WzFaxB_A7xY,48,86,8,142,0.3380281690140845,0.3380281690140845,0.6056338028169014
X-i7rHPQ_OY,6,12,2,20,0.3,0.3,0.6
X1T9toSxep0,30,72,6,108,0.2777777777777778,0.2777777777777778,0.6666666666666666
X2PX5LZOepc,5,8,1,14,0.35714285714285715,0.35714285714285715,0.5714285714285714
X3jWm4Up6K8,41,38,3,82,0.5,0.5,0.4634146341463415
X47B-yf1UCs,17,30,3,50,0.34,0.34,0.6
X4SbxSabfaI,11,18,0,29,0.3793103448275862,0.3793103448275862,0.6206896551724138
X4gtnRzf0Ao,7,5,3,15,0.4666666666666667,0.4666666666666667,0.3333333333333333
X5COYHcM-E8,2,11,1,14,0.14285714285714285,0.14285714285714285,0.7857142857142857
X5FtCR4ywYA,16,32,1,49,0.32653061224489793,0.32653061224489793,0.6530612244897959
X8ShNvZpvpI,0,2,1,3,0,0,0.6666666666666666
XAOGtR3zZKM,9,22,1,32,0.28125,0.28125,0.6875
XBEUi05vWdE,4,14,4,22,0.18181818181818182,0.18181818181818182,0.6363636363636364
XCVrye04peY,167,151,18,336,0.49702380952380953,0.49702380952380953,0.4494047619047619
XCXD9yhF1zU,7,11,2,20,0.35,0.35,0.55
XD6T0xnykCM,16,19,2,37,0.43243243243243246,0.43243243243243246,0.5135135135135135
XDWrQENQIyE,14,50,2,66,0.21212121212121213,0.21212121212121213,0.7575757575757576
XDhBJni9HDc,19,29,6,54,0.35185185185185186,0.35185185185185186,0.5370370370370371
XDl14C7KWeg,16,29,3,48,0.3333333333333333,0.3333333333333333,0.6041666666666666
XEMSrI2pW4c,9,12,1,22,0.4090909090909091,0.4090909090909091,0.5454545454545454
XFwnqXQhw0I,61,46,7,114,0.5350877192982456,0.5350877192982456,0.40350877192982454
XGq-U7Q-ets,173,123,25,321,0.5389408099688473,0.5389408099688473,0.38317757009345793
XH5rkl8nKQc,39,82,9,130,0.3,0.3,0.6307692307692307
XHWV1B8o0VQ,7,23,2,32,0.21875,0.21875,0.71875
XI14S5Nzgas,3,0,0,3,1,1,0
XIQ4V9-TpRY,19,92,10,121,0.15702479338842976,0.15702479338842976,0.7603305785123967
XIXp37vpylk,25,50,6,81,0.30864197530864196,0.30864197530864196,0.6172839506172839
XJ0twOkMQ94,12,35,4,51,0.23529411764705882,0.23529411764705882,0.6862745098039216
XJ1DMeCPP58,14,19,4,37,0.3783783783783784,0.3783783783783784,0.5135135135135135
XJXY0XdWAP4,2,6,0,8,0.25,0.25,0.75
XJhcKbT9Xsg,18,65,2,85,0.21176470588235294,0.21176470588235294,0.7647058823529411
XKSEh787Wa8,3,8,0,11,0.2727272727272727,0.2727272727272727,0.7272727272727273
XKhff_-V4YA,9,2,2,13,0.6923076923076923,0.6923076923076923,0.15384615384615385
XL9S1FGpWxU,3,14,1,18,0.16666666666666666,0.16666666666666666,0.7777777777777778
XLOuR5ojeg4,24,12,3,39,0.6153846153846154,0.6153846153846154,0.3076923076923077
XLhk9iABnKM,22,20,4,46,0.4782608695652174,0.4782608695652174,0.43478260869565216
XM2e_odFFjs,9,15,0,24,0.375,0.375,0.625
XMrCw08z7oE,1,4,0,5,0.2,0.2,0.8
XMtffQqvsFw,24,17,5,46,0.5217391304347826,0.5217391304347826,0.3695652173913043
XNmSON_5DwQ,4,25,1,30,0.13333333333333333,0.13333333333333333,0.8333333333333334
XOM9vlRjlnk,36,12,2,50,0.72,0.72,0.24
XP9VRMvxyu4,10,4,0,14,0.7142857142857143,0.7142857142857143,0.2857142857142857
XPjFktmxwPw,16,21,5,42,0.38095238095238093,0.38095238095238093,0.5
XR97TCSLeM8,26,22,4,52,0.5,0.5,0.4230769230769231
XRNv5SSZA_M,3,17,0,20,0.15,0.15,0.85
XT-oXLxwKO4,10,21,5,36,0.2777777777777778,0.2777777777777778,0.5833333333333334
XTcnbv1Jw0A,55,158,40,253,0.21739130434782608,0.21739130434782608,0.6245059288537549
XU0CqWIoor0,7,21,0,28,0.25,0.25,0.75
XU0W0NLpNcY,3,9,1,13,0.23076923076923078,0.23076923076923078,0.6923076923076923
XVBe8XEFRXI,36,16,4,56,0.6428571428571429,0.6428571428571429,0.2857142857142857
XVw6H6tySlk,5,18,1,24,0.20833333333333334,0.20833333333333334,0.75
XWWhfCeOsmo,112,46,21,179,0.6256983240223464,0.6256983240223464,0.2569832402234637
XXhf7etzsk4,5,18,4,27,0.18518518518518517,0.18518518518518517,0.6666666666666666
XYFNLljn1sw,58,204,15,277,0.20938628158844766,0.20938628158844766,0.7364620938628159
XYUQ-DrD0sQ,7,8,1,16,0.4375,0.4375,0.5
XYZG8GfdKEM,6,14,3,23,0.2608695652173913,0.2608695652173913,0.6086956521739131
X_1Ecxt0TfQ,21,34,4,59,0.3559322033898305,0.3559322033898305,0.576271186440678
X_29cpRFHPw,16,43,2,61,0.26229508196721313,0.26229508196721313,0.7049180327868853
XayibzjBLP4,6,22,5,33,0.18181818181818182,0.18181818181818182,0.6666666666666666
XcHHywIaayE,5,5,0,10,0.5,0.5,0.5
XgF_9BWLKZc,10,25,4,39,0.2564102564102564,0.2564102564102564,0.6410256410256411
XgQykyY_bXg,9,4,0,13,0.6923076923076923,0.6923076923076923,0.3076923076923077
XhbebxZPXiw,4,7,2,13,0.3076923076923077,0.3076923076923077,0.5384615384615384
XhoLQPjyjNs,28,30,7,65,0.4307692307692308,0.4307692307692308,0.46153846153846156
XhxG_4jORU4,14,30,2,46,0.30434782608695654,0.30434782608695654,0.6521739130434783
Xiw9G0x55tY,12,50,5,67,0.1791044776119403,0.1791044776119403,0.746268656716418
XjCw5tk1pFk,43,113,11,167,0.25748502994011974,0.25748502994011974,0.6766467065868264
XkIDgDfUwYQ,2,22,0,24,0.08333333333333333,0.08333333333333333,0.9166666666666666
Xkg8hpapVec,18,22,1,41,0.43902439024390244,0.43902439024390244,0.5365853658536586
XlNPta8Qv1Q,49,203,14,266,0.18421052631578946,0.18421052631578946,0.7631578947368421
XnGndBTAuWo,13,43,5,61,0.21311475409836064,0.21311475409836064,0.7049180327868853
XnPAfXvFswk,0,7,1,8,0,0,0.875
Xntnp87SyGk,14,31,2,47,0.2978723404255319,0.2978723404255319,0.6595744680851063
XoqzuwZgITc,33,120,2,155,0.2129032258064516,0.2129032258064516,0.7741935483870968
XpC_O2q82eA,11,17,2,30,0.36666666666666664,0.36666666666666664,0.5666666666666667
XpkvfAuU0MQ,10,17,0,27,0.37037037037037035,0.37037037037037035,0.6296296296296297
XrOz7hIFN4s,66,96,9,171,0.38596491228070173,0.38596491228070173,0.5614035087719298
Xss9uH07Ckw,5,63,4,72,0.06944444444444445,0.06944444444444445,0.875
XwRaYMdaHd8,3,23,3,29,0.10344827586206896,0.10344827586206896,0.7931034482758621
XwhMK3XzkIY,3,1,0,4,0.75,0.75,0.25
Xxh45wQ5VwQ,4,9,3,16,0.25,0.25,0.5625
XxkEwhYcF3M,28,75,7,110,0.2545454545454545,0.2545454545454545,0.6818181818181818
Xz90EFQVeWE,7,32,3,42,0.16666666666666666,0.16666666666666666,0.7619047619047619
XzSJSm81Prk,1,5,2,8,0.125,0.125,0.625
Y1e1WiB9GNo,157,145,21,323,0.48606811145510836,0.48606811145510836,0.44891640866873067
Y41VQXwEPik,45,35,4,84,0.5357142857142857,0.5357142857142857,0.4166666666666667
Y4GFDdCHrEI,21,59,6,86,0.2441860465116279,0.2441860465116279,0.686046511627907
Y59zGfcAQY8,13,83,12,108,0.12037037037037036,0.12037037037037036,0.7685185185185185
Y61QHrMnyYk,7,42,1,50,0.14,0.14,0.84
Y6NrtG-fSwM,41,12,1,54,0.7592592592592593,0.7592592592592593,0.2222222222222222
Y6W0hSFiWDw,163,772,158,1093,0.14913083257090576,0.14913083257090576,0.7063129002744739
Y7NzeWUTNH4,6,14,1,21,0.2857142857142857,0.2857142857142857,0.6666666666666666
Y7ucI45xYFE,4,18,7,29,0.13793103448275862,0.13793103448275862,0.6206896551724138
Y8EOOUNjLUw,8,8,1,17,0.47058823529411764,0.47058823529411764,0.47058823529411764
Y8HU-kh7H9g,4,4,1,9,0.4444444444444444,0.4444444444444444,0.4444444444444444
Y8lb9mHmtvM,17,47,9,73,0.2328767123287671,0.2328767123287671,0.6438356164383562
Y9BoA6ospS8,25,35,8,68,0.36764705882352944,0.36764705882352944,0.5147058823529411
Y9TrJ-ilpac,5,8,5,18,0.2777777777777778,0.2777777777777778,0.4444444444444444
Y9nHrNUImig,204,548,100,852,0.23943661971830985,0.23943661971830985,0.6431924882629108
Y9xBFit9C9o,6,14,4,24,0.25,0.25,0.5833333333333334
Y9xY5QzniYA,31,47,4,82,0.3780487804878049,0.3780487804878049,0.573170731707317
YEhlnM6QhWA,14,17,3,34,0.4117647058823529,0.4117647058823529,0.5
YEnofxo13Xo,8,10,2,20,0.4,0.4,0.5
YEyE5oIB0gM,0,3,0,3,0,0,1
YF4-EZi8uqg,5,17,0,22,0.22727272727272727,0.22727272727272727,0.7727272727272727
YGtm3jO2enI,2,5,1,8,0.25,0.25,0.625
YHa2GWoxVhs,691,464,108,1263,0.5471100554235946,0.5471100554235946,0.3673792557403009
YIgzpju5-7s,8,19,3,30,0.26666666666666666,0.26666666666666666,0.6333333333333333
YIxW4ATGtBU,123,54,10,187,0.6577540106951871,0.6577540106951871,0.2887700534759358
YK7IGSaPZoQ,10,26,1,37,0.2702702702702703,0.2702702702702703,0.7027027027027027
YL525e0uui4,5,17,4,26,0.19230769230769232,0.19230769230769232,0.6538461538461539
YL7sPo9xKgo,21,79,4,104,0.20192307692307693,0.20192307692307693,0.7596153846153846
YLZsLmF_rCM,4,7,2,13,0.3076923076923077,0.3076923076923077,0.5384615384615384
YNMBNnqKJVg,8,7,3,18,0.4444444444444444,0.4444444444444444,0.3888888888888889
YOOshbG793s,7,7,1,15,0.4666666666666667,0.4666666666666667,0.4666666666666667
YOjYvKnRgKM,6,25,2,33,0.18181818181818182,0.18181818181818182,0.7575757575757576
YP3OliJZbkU,4,2,0,6,0.6666666666666666,0.6666666666666666,0.3333333333333333
YPEZb4gw6wc,1,3,1,5,0.2,0.2,0.6
YQAad7WGUXc,8,14,1,23,0.34782608695652173,0.34782608695652173,0.6086956521739131
YQm_U8KuLcE,185,307,31,523,0.35372848948374763,0.35372848948374763,0.5869980879541109
YQrNuNbnVdw,35,22,2,59,0.5932203389830508,0.5932203389830508,0.3728813559322034
YSXVB4LbtaY,20,8,2,30,0.6666666666666666,0.6666666666666666,0.26666666666666666
YT3hAEDEN-k,12,8,0,20,0.6,0.6,0.4
YUHJUviiQZo,7,41,2,50,0.14,0.14,0.82
YUaWLDqN-Uk,10,4,1,15,0.6666666666666666,0.6666666666666666,0.26666666666666666
YV5yg0MwVmM,1104,2461,436,4001,0.2759310172456886,0.2759310172456886,0.6150962259435141
YV9w_6LU72o,12,46,2,60,0.2,0.2,0.7666666666666667
YVahrl2GN5A,744,557,143,1444,0.5152354570637119,0.5152354570637119,0.38573407202216065
YVy2SQCCSoE,23,44,3,70,0.32857142857142857,0.32857142857142857,0.6285714285714286
YW4jpNpA8sU,114,81,19,214,0.5327102803738317,0.5327102803738317,0.37850467289719625
YXhtDN4Wcqg,6,3,2,11,0.5454545454545454,0.5454545454545454,0.2727272727272727
Y_BmdgJv8N8,1,10,0,11,0.09090909090909091,0.09090909090909091,0.9090909090909091
YcIA9n_wvF4,61,78,10,149,0.40939597315436244,0.40939597315436244,0.5234899328859061
YcPY7pJrSUc,3,2,1,6,0.5,0.5,0.3333333333333333
YckOyKuovHg,15,39,6,60,0.25,0.25,0.65
YfSIsqxezCY,10,6,0,16,0.625,0.625,0.375
YiOjeoNAioA,8,12,1,21,0.38095238095238093,0.38095238095238093,0.5714285714285714
YimgWYWGwyE,8,6,0,14,0.5714285714285714,0.5714285714285714,0.42857142857142855
Yj4igqadOR4,56,108,12,176,0.3181818181818182,0.3181818181818182,0.6136363636363636
YlAyuIyT2wY,1,3,1,5,0.2,0.2,0.6
YljjETFNtYE,1,10,2,13,0.07692307692307693,0.07692307692307693,0.7692307692307693
YnDUzEQ04is,59,25,6,90,0.6555555555555556,0.6555555555555556,0.2777777777777778
YnfmsR_6-o0,14,47,7,68,0.20588235294117646,0.20588235294117646,0.6911764705882353
YnyFq8KWFeg,15,24,3,42,0.35714285714285715,0.35714285714285715,0.5714285714285714
YoX7B-USgIY,6,22,2,30,0.2,0.2,0.7333333333333333
YpT9ANFIgBc,4,7,2,13,0.3076923076923077,0.3076923076923077,0.5384615384615384
Ypc4al0NCiQ,47,44,6,97,0.4845360824742268,0.4845360824742268,0.4536082474226804
YshTPemALLQ,2,2,1,5,0.4,0.4,0.4
Ysw1JGwkWo8,11,13,0,24,0.4583333333333333,0.4583333333333333,0.5416666666666666
YtcQvCzg4kU,10,16,2,28,0.35714285714285715,0.35714285714285715,0.5714285714285714
YuleHQAcvQE,12,20,3,35,0.34285714285714286,0.34285714285714286,0.5714285714285714
Yvjp5V6O3-0,1,1,2,4,0.25,0.25,0.25
YwHlEclsFo0,284,614,72,970,0.2927835051546392,0.2927835051546392,0.6329896907216495
YwNv6so8BMI,98,128,20,246,0.3983739837398374,0.3983739837398374,0.5203252032520326
YxXgjIyP2Ro,4,3,1,8,0.5,0.5,0.375
YzEaRg0Wrqk,16,4,0,20,0.8,0.8,0.2
YzoMQTvzLqQ,9,51,4,64,0.140625,0.140625,0.796875
Z-_2oo2MFJc,6,3,0,9,0.6666666666666666,0.6666666666666666,0.3333333333333333
Z-cWj3u5ges,7,7,1,15,0.4666666666666667,0.4666666666666667,0.4666666666666667
Z-jYuWWfrKY,131,118,12,261,0.5019157088122606,0.5019157088122606,0.4521072796934866
Z-lFFxgdiyk,9,55,10,74,0.12162162162162163,0.12162162162162163,0.7432432432432432
Z0xwQ6nKGvo,24,47,4,75,0.32,0.32,0.6266666666666667
Z1JytoRAvlU,11,18,0,29,0.3793103448275862,0.3793103448275862,0.6206896551724138
Z2xDtQOccfQ,16,17,2,35,0.45714285714285713,0.45714285714285713,0.4857142857142857
Z4hEz-aLXlE,19,13,0,32,0.59375,0.59375,0.40625
Z53VPtiR6ak,41,53,6,100,0.41,0.41,0.53
Z75LKIzbtxI,4,6,2,12,0.3333333333333333,0.3333333333333333,0.5
Z7LxYrkDfxA,27,28,3,58,0.46551724137931033,0.46551724137931033,0.4827586206896552
Z7dRzfNc5C4,4,19,2,25,0.16,0.16,0.76
Z7q_9fFCYY4,17,25,5,47,0.3617021276595745,0.3617021276595745,0.5319148936170213
Z8ln0JJUu2I,8,10,2,20,0.4,0.4,0.5
ZAAJXTD7rw4,13,58,7,78,0.16666666666666666,0.16666666666666666,0.7435897435897436
ZAFJx9-pvfo,26,43,3,72,0.3611111111111111,0.3611111111111111,0.5972222222222222
ZAf3NnKxUhk,134,81,8,223,0.600896860986547,0.600896860986547,0.3632286995515695
ZBN_lHMiJ_A,3,13,0,16,0.1875,0.1875,0.8125
ZCgo3yfNWMA,26,32,5,63,0.4126984126984127,0.4126984126984127,0.5079365079365079
ZDoDJ5yi5zM,16,50,4,70,0.22857142857142856,0.22857142857142856,0.7142857142857143
ZDrqHYVe8z0,20,19,5,44,0.45454545454545453,0.45454545454545453,0.4318181818181818
ZF_-uPLaG8w,95,22,2,119,0.7983193277310925,0.7983193277310925,0.18487394957983194
ZGMvbM_WNiw,93,290,48,431,0.21577726218097448,0.21577726218097448,0.6728538283062645
ZGs6PdYYw_k,4,17,3,24,0.16666666666666666,0.16666666666666666,0.7083333333333334
ZIW_mMXdsyc,63,47,7,117,0.5384615384615384,0.5384615384615384,0.4017094017094017
ZIaZuX4bILU,22,31,4,57,0.38596491228070173,0.38596491228070173,0.543859649122807
ZJcPFG-w3mU,9,41,2,52,0.17307692307692307,0.17307692307692307,0.7884615384615384
ZKSMBNb05L0,2,2,1,5,0.4,0.4,0.4
ZKdc8Ed9MUo,93,90,7,190,0.48947368421052634,0.48947368421052634,0.47368421052631576
ZLaaBB4fWXs,34,63,7,104,0.3269230769230769,0.3269230769230769,0.6057692307692307
ZML4cExDlzg,4,15,3,22,0.18181818181818182,0.18181818181818182,0.6818181818181818
ZMbTyQ4dWQ4,7,7,1,15,0.4666666666666667,0.4666666666666667,0.4666666666666667
ZP82_YugBc8,18,88,6,112,0.16071428571428573,0.16071428571428573,0.7857142857142857
ZPIjccLbqRw,4,4,0,8,0.5,0.5,0.5
ZReiflg5jQ8,2,2,0,4,0.5,0.5,0.5
ZSpcz19ba4U,8,23,2,33,0.24242424242424243,0.24242424242424243,0.696969696969697
ZSuWySymB00,3,8,0,11,0.2727272727272727,0.2727272727272727,0.7272727272727273
ZW8lsJZzzIk,151,143,31,325,0.4646153846153846,0.4646153846153846,0.44
ZWjHmZwV09I,24,26,10,60,0.4,0.4,0.43333333333333335
ZWtbFfz1rjo,6,15,3,24,0.25,0.25,0.625
ZYXThLQ5MGQ,13,42,3,58,0.22413793103448276,0.22413793103448276,0.7241379310344828
Z_JxEmxxIjo,92,123,20,235,0.39148936170212767,0.39148936170212767,0.5234042553191489
Z_a-TjB2wAI,5,8,3,16,0.3125,0.3125,0.5
ZcWvCN62Y1k,8,16,0,24,0.3333333333333333,0.3333333333333333,0.6666666666666666
ZcYd0joCkKQ,18,80,2,100,0.18,0.18,0.8
Zd0w_-l0oxQ,1,1,0,2,0.5,0.5,0.5
Ze_IbcBZKj8,15,20,2,37,0.40540540540540543,0.40540540540540543,0.5405405405405406
Zeh7hhChk6s,8,2,0,10,0.8,0.8,0.2
ZgLc4k_VWAg,88,68,13,169,0.5207100591715976,0.5207100591715976,0.40236686390532544
ZhHhAcLRxY0,6,19,1,26,0.23076923076923078,0.23076923076923078,0.7307692307692307
ZiiTLFpB8M0,2,104,4,110,0.01818181818181818,0.01818181818181818,0.9454545454545454
ZklBuYQmT0s,2,9,1,12,0.16666666666666666,0.16666666666666666,0.75
ZmQeNlV_8aw,3,9,0,12,0.25,0.25,0.75
ZntS05mIr0A,4,4,1,9,0.4444444444444444,0.4444444444444444,0.4444444444444444
ZowA_4NCZ-Y,4,4,1,9,0.4444444444444444,0.4444444444444444,0.4444444444444444
ZpTKoW-YGMw,53,296,10,359,0.14763231197771587,0.14763231197771587,0.8245125348189415
ZrOeA_Qwvf4,15,59,8,82,0.18292682926829268,0.18292682926829268,0.7195121951219512
ZsUsO2OySX8,18,17,1,36,0.5,0.5,0.4722222222222222
Zt-2KCsVlJ8,9,7,0,16,0.5625,0.5625,0.4375
Zt4Q6ImsmYw,23,24,4,51,0.45098039215686275,0.45098039215686275,0.47058823529411764
ZvCyWLQtuE0,19,74,19,112,0.16964285714285715,0.16964285714285715,0.6607142857142857
ZwYZS99_hJw,4,0,2,6,0.6666666666666666,0.6666666666666666,0
_0Lp3cXUyso,13,23,2,38,0.34210526315789475,0.34210526315789475,0.6052631578947368
_1VGAJDwEvI,9,27,3,39,0.23076923076923078,0.23076923076923078,0.6923076923076923
_1zHd0fwDjY,21,24,2,47,0.44680851063829785,0.44680851063829785,0.5106382978723404
_2OfviRabUo,36,68,2,106,0.33962264150943394,0.33962264150943394,0.6415094339622641
_2QzqbtzeAs,92,14,4,110,0.8363636363636363,0.8363636363636363,0.12727272727272726
_4FBLoDGM1I,4,11,1,16,0.25,0.25,0.6875
_5QITDE5FlE,7,11,1,19,0.3684210526315789,0.3684210526315789,0.5789473684210527
_6CvtEhI-F0,3,10,1,14,0.21428571428571427,0.21428571428571427,0.7142857142857143
_6xBPtLIa0Q,13,21,6,40,0.325,0.325,0.525
_82me3lbFvs,4,11,0,15,0.26666666666666666,0.26666666666666666,0.7333333333333333
_9Cf3jsFEs8,12,78,5,95,0.12631578947368421,0.12631578947368421,0.8210526315789474
_9GEKh5htVY,51,200,23,274,0.18613138686131386,0.18613138686131386,0.7299270072992701
_AYNhPjThzo,16,20,4,40,0.4,0.4,0.5
_BK6R2oarQo,46,198,17,261,0.17624521072796934,0.17624521072796934,0.7586206896551724
_BXMwEnhhwU,3,3,0,6,0.5,0.5,0.5
_BhJn5l8ITA,32,86,6,124,0.25806451612903225,0.25806451612903225,0.6935483870967742
_Cg4FHLTA4s,29,26,1,56,0.5178571428571429,0.5178571428571429,0.4642857142857143
_F-4iizGBiY,36,112,3,151,0.23841059602649006,0.23841059602649006,0.7417218543046358
_FUN_bhRv4w,12,23,1,36,0.3333333333333333,0.3333333333333333,0.6388888888888888
_FaaoAra3A0,17,4,2,23,0.7391304347826086,0.7391304347826086,0.17391304347826086
_Gaib4ZoXCs,39,32,7,78,0.5,0.5,0.41025641025641024
_GoFJxEKM-U,24,45,2,71,0.3380281690140845,0.3380281690140845,0.6338028169014085
_HHWY09VCio,13,19,2,34,0.38235294117647056,0.38235294117647056,0.5588235294117647
_HQH-WB1Q-U,19,51,6,76,0.25,0.25,0.6710526315789473
_HW6hmjAxdc,1,19,2,22,0.045454545454545456,0.045454545454545456,0.8636363636363636
_HWTBORa7YU,3,5,0,8,0.375,0.375,0.625
_HeRdHLfWo0,5,55,7,67,0.07462686567164178,0.07462686567164178,0.8208955223880597
_I3BO69WkAI,9,59,1,69,0.13043478260869565,0.13043478260869565,0.855072463768116
_I__z7yMnp8,23,13,0,36,0.6388888888888888,0.6388888888888888,0.3611111111111111
_Jud7LdqMSw,40,45,5,90,0.4444444444444444,0.4444444444444444,0.5
_JvKIfGcAGo,2,30,2,34,0.058823529411764705,0.058823529411764705,0.8823529411764706
_K3TiX-cEJk,12,30,1,43,0.27906976744186046,0.27906976744186046,0.6976744186046512
_LZ8u_WK9j8,9,4,0,13,0.6923076923076923,0.6923076923076923,0.3076923076923077
_OsZbSo9OBk,23,15,1,39,0.5897435897435898,0.5897435897435898,0.38461538461538464
_PBB3aPUkkQ,2,16,0,18,0.1111111111111111,0.1111111111111111,0.8888888888888888
_PEweiVnNMM,670,2597,441,3708,0.18069039913700108,0.18069039913700108,0.7003775620280475
_PWA_oa0Atk,61,37,10,108,0.5648148148148148,0.5648148148148148,0.3425925925925926
_Qde8-m8z00,14,7,5,26,0.5384615384615384,0.5384615384615384,0.2692307692307692
_RLr_rJXzFM,3,6,0,9,0.3333333333333333,0.3333333333333333,0.6666666666666666
_SkC_AWTvmU,17,7,0,24,0.7083333333333334,0.7083333333333334,0.2916666666666667
_TMzJRWalxA,91,49,7,147,0.6190476190476191,0.6190476190476191,0.3333333333333333
_UcvohtdLDM,1,2,1,4,0.25,0.25,0.5
_VBqiMXR61Y,4,13,1,18,0.2222222222222222,0.2222222222222222,0.7222222222222222
_VzjpJxkLwk,43,74,11,128,0.3359375,0.3359375,0.578125
_WHBj_zjSmE,4,15,3,22,0.18181818181818182,0.18181818181818182,0.6818181818181818
_X2y-En-cGE,54,76,5,135,0.4,0.4,0.562962962962963
_XFooluP_pE,4,24,3,31,0.12903225806451613,0.12903225806451613,0.7741935483870968
_YCxYY4w8hw,25,43,4,72,0.3472222222222222,0.3472222222222222,0.5972222222222222
_ZmOtQ1xZE4,15,5,3,23,0.6521739130434783,0.6521739130434783,0.21739130434782608
_ZyCIUpWj9U,5,11,1,17,0.29411764705882354,0.29411764705882354,0.6470588235294118
_Zy_zLuh07Y,15,100,13,128,0.1171875,0.1171875,0.78125
__hFnCbK2DI,17,47,1,65,0.26153846153846155,0.26153846153846155,0.7230769230769231
_ageRBOGtDI,53,37,13,103,0.5145631067961165,0.5145631067961165,0.3592233009708738
_b--BIWl6h0,79,109,4,192,0.4114583333333333,0.4114583333333333,0.5677083333333334
_b2wmlI4xrg,8,6,2,16,0.5,0.5,0.375
_cgu2SzqCWk,28,25,7,60,0.4666666666666667,0.4666666666666667,0.4166666666666667
_dEgL_EW8P0,11,6,3,20,0.55,0.55,0.3
_dYSYLXQd-c,317,46,14,377,0.8408488063660478,0.8408488063660478,0.1220159151193634
_f0ehszvyhk,5,10,3,18,0.2777777777777778,0.2777777777777778,0.5555555555555556
_g-OkUK5Giw,5,28,7,40,0.125,0.125,0.7
_hNS1I3CLKw,134,97,35,266,0.5037593984962406,0.5037593984962406,0.36466165413533835
_iFWbor7S2w,12,38,1,51,0.23529411764705882,0.23529411764705882,0.7450980392156863
_oaiE-ai4AA,25,20,2,47,0.5319148936170213,0.5319148936170213,0.425531914893617
_rfCTvz4jz4,2,0,0,2,1,1,0
_sglztw2H0M,20,16,1,37,0.5405405405405406,0.5405405405405406,0.43243243243243246
_vJk_g2Yx_8,22,37,9,68,0.3235294117647059,0.3235294117647059,0.5441176470588235
_vy4s6VBwAE,9,31,6,46,0.1956521739130435,0.1956521739130435,0.6739130434782609
_wSoTcs9WQE,12,13,1,26,0.46153846153846156,0.46153846153846156,0.5
_whxhhFUE3E,7,5,4,16,0.4375,0.4375,0.3125
_y7NdOeEXu4,101,52,9,162,0.6234567901234568,0.6234567901234568,0.32098765432098764
_zj6aeJJd7M,16,50,7,73,0.2191780821917808,0.2191780821917808,0.684931506849315
a-qvarhLNZM,26,49,11,86,0.3023255813953488,0.3023255813953488,0.5697674418604651
a-r59cJH1fs,4,0,0,4,1,1,0
a03IOLp8-Ug,13,40,1,54,0.24074074074074073,0.24074074074074073,0.7407407407407407
a0UJ_FE3T_0,17,64,10,91,0.18681318681318682,0.18681318681318682,0.7032967032967034
a0hD8zwu8mQ,31,128,12,171,0.18128654970760233,0.18128654970760233,0.7485380116959064
a0lnqelAb5M,18,25,2,45,0.4,0.4,0.5555555555555556
a0q2bHJbjx0,42,15,1,58,0.7241379310344828,0.7241379310344828,0.25862068965517243
a1_xpl6Y_8o,7,24,2,33,0.21212121212121213,0.21212121212121213,0.7272727272727273
a1vfMYO4q5s,40,45,10,95,0.42105263157894735,0.42105263157894735,0.47368421052631576
a2LvE3hvh_8,84,329,29,442,0.19004524886877827,0.19004524886877827,0.744343891402715
a2R5Qviqv-0,2,5,0,7,0.2857142857142857,0.2857142857142857,0.7142857142857143
a2YSnTlmndI,2,2,1,5,0.4,0.4,0.4
a2_jXL7Vqfo,6,32,3,41,0.14634146341463414,0.14634146341463414,0.7804878048780488
a2nQgEwM5w0,76,258,14,348,0.21839080459770116,0.21839080459770116,0.7413793103448276
a3e3FYPv8-8,64,150,8,222,0.2882882882882883,0.2882882882882883,0.6756756756756757
a4EnZIZ8chc,4,3,0,7,0.5714285714285714,0.5714285714285714,0.42857142857142855
a4cXkA27_7g,2,1,2,5,0.4,0.4,0.2
a5B_6EFv5GA,15,32,3,50,0.3,0.3,0.64
a7HV29RfNzQ,11,57,8,76,0.14473684210526316,0.14473684210526316,0.75
a8FrxCokfCA,15,65,2,82,0.18292682926829268,0.18292682926829268,0.7926829268292683
aAL4riykMgg,7,5,1,13,0.5384615384615384,0.5384615384615384,0.38461538461538464
aAhAaw2nuy0,3,7,1,11,0.2727272727272727,0.2727272727272727,0.6363636363636364
aC0YSngvmvg,7,2,2,11,0.6363636363636364,0.6363636363636364,0.18181818181818182
aCPbkWB2KoI,19,74,7,100,0.19,0.19,0.74
aCcNTx89LAM,58,139,31,228,0.2543859649122807,0.2543859649122807,0.6096491228070176
aCd_Cv9kftc,18,24,0,42,0.42857142857142855,0.42857142857142855,0.5714285714285714
aDycP9CiiJM,10,21,2,33,0.30303030303030304,0.30303030303030304,0.6363636363636364
aEJ65HzuR0k,3,2,1,6,0.5,0.5,0.3333333333333333
aFec4ymERrQ,32,30,4,66,0.48484848484848486,0.48484848484848486,0.45454545454545453
aG_6ucMVszw,64,70,9,143,0.44755244755244755,0.44755244755244755,0.48951048951048953
aH73C54zAI0,5,11,0,16,0.3125,0.3125,0.6875
aIObMcdPn1g,2,4,3,9,0.2222222222222222,0.2222222222222222,0.4444444444444444
aIYBQmZ5jY0,8,28,4,40,0.2,0.2,0.7
aItiClzMJ0o,4,1,0,5,0.8,0.8,0.2
aJ7nmLf_rwc,7,27,1,35,0.2,0.2,0.7714285714285715
aKaR7LZZP7I,3,12,2,17,0.17647058823529413,0.17647058823529413,0.7058823529411765
aKomsw3RzKI,89,171,14,274,0.3248175182481752,0.3248175182481752,0.6240875912408759
aMCmRhyo6DQ,5,17,0,22,0.22727272727272727,0.22727272727272727,0.7727272727272727
aMVwL5XHAkg,4,7,1,12,0.3333333333333333,0.3333333333333333,0.5833333333333334
aMn-0JY4oSA,13,11,3,27,0.48148148148148145,0.48148148148148145,0.4074074074074074
aNDhgbXkREY,13,1,0,14,0.9285714285714286,0.9285714285714286,0.07142857142857142
aNMujjYCbys,10,4,1,15,0.6666666666666666,0.6666666666666666,0.26666666666666666
aNYaaV21tFU,3,6,4,13,0.23076923076923078,0.23076923076923078,0.46153846153846156
aOar-QF4XTU,24,19,0,43,0.5581395348837209,0.5581395348837209,0.4418604651162791
aP-lirxHS7E,132,128,9,269,0.49070631970260226,0.49070631970260226,0.4758364312267658
aPaxvXLmRaQ,3,0,0,3,1,1,0
aQIRuegZrAg,30,16,5,51,0.5882352941176471,0.5882352941176471,0.3137254901960784
aRUaLmbGnsE,45,8,4,57,0.7894736842105263,0.7894736842105263,0.14035087719298245
aSEsfnWSag8,1,1,0,2,0.5,0.5,0.5
aTBbdX1W62w,16,50,5,71,0.22535211267605634,0.22535211267605634,0.704225352112676
aTXEmOdqFSc,6,12,0,18,0.3333333333333333,0.3333333333333333,0.6666666666666666
aVSQO_7gJPM,49,91,17,157,0.31210191082802546,0.31210191082802546,0.5796178343949044
aVdHCZBsM4A,11,22,1,34,0.3235294117647059,0.3235294117647059,0.6470588235294118
aWOy7ONqktk,16,13,3,32,0.5,0.5,0.40625
aXCCaz6ZfnA,34,51,9,94,0.3617021276595745,0.3617021276595745,0.5425531914893617
aY4nxSYBndk,24,209,15,248,0.0967741935483871,0.0967741935483871,0.842741935483871
aYQEGgvqgkU,8,9,3,20,0.4,0.4,0.45
aYjrV0ozxjc,64,48,5,117,0.5470085470085471,0.5470085470085471,0.41025641025641024
a_i68q2C-eE,8,21,1,30,0.26666666666666666,0.26666666666666666,0.7
aamB4ipZkN0,9,9,0,18,0.5,0.5,0.5
aan5kARV-30,649,804,133,1586,0.40920554854981084,0.40920554854981084,0.5069356872635561
abfzdKTW7gE,6,25,1,32,0.1875,0.1875,0.78125
acwZYFzG5rY,32,75,6,113,0.2831858407079646,0.2831858407079646,0.6637168141592921
aeUlIG15RC4,33,42,5,80,0.4125,0.4125,0.525
aiPPybsEbWs,2,0,0,2,1,1,0
ajAWs-CTmOU,5,15,4,24,0.20833333333333334,0.20833333333333334,0.625
akLu_BG3LwA,8,18,0,26,0.3076923076923077,0.3076923076923077,0.6923076923076923
akMHcIGuqRQ,5,32,1,38,0.13157894736842105,0.13157894736842105,0.8421052631578947
akTmzs_2SG8,8,33,6,47,0.1702127659574468,0.1702127659574468,0.7021276595744681
akb8k-hDCnk,6,2,0,8,0.75,0.75,0.25
akpNWjwHg3A,4,17,3,24,0.16666666666666666,0.16666666666666666,0.7083333333333334
al49Qg2vSnY,14,25,0,39,0.358974358974359,0.358974358974359,0.6410256410256411
alKoOYnF8jM,0,1,1,2,0,0,0.5
am8Fm-AyKEE,96,198,24,318,0.3018867924528302,0.3018867924528302,0.6226415094339622
anQTVTx7rUw,5,22,1,28,0.17857142857142858,0.17857142857142858,0.7857142857142857
anVzmdhcRQg,6,25,3,34,0.17647058823529413,0.17647058823529413,0.7352941176470589
anyqtLwmPW8,6,15,2,23,0.2608695652173913,0.2608695652173913,0.6521739130434783
ao-x3RBrSvo,10,10,2,22,0.45454545454545453,0.45454545454545453,0.45454545454545453
aoJFMW5YJxI,10,54,1,65,0.15384615384615385,0.15384615384615385,0.8307692307692308
ap0KCVo4RkE,1,3,1,5,0.2,0.2,0.6
apREpGHR6Z0,8,19,6,33,0.24242424242424243,0.24242424242424243,0.5757575757575758
apWZb02HCCc,12,18,4,34,0.35294117647058826,0.35294117647058826,0.5294117647058824
apYwTk94VYw,12,19,3,34,0.35294117647058826,0.35294117647058826,0.5588235294117647
aq9rGpEkhEc,245,427,25,697,0.351506456241033,0.351506456241033,0.6126255380200861
aqH10NJbJlc,99,90,8,197,0.5025380710659898,0.5025380710659898,0.45685279187817257
ar-DeZ56ZgM,22,11,2,35,0.6285714285714286,0.6285714285714286,0.3142857142857143
arjjGFT40EM,18,173,28,219,0.0821917808219178,0.0821917808219178,0.7899543378995434
as_fflKdEKE,4,5,0,9,0.4444444444444444,0.4444444444444444,0.5555555555555556
asn19u4rZ-w,4,29,3,36,0.1111111111111111,0.1111111111111111,0.8055555555555556
au2vFMnBRio,11,35,0,46,0.2391304347826087,0.2391304347826087,0.7608695652173914
auP029KCGgY,6,4,1,11,0.5454545454545454,0.5454545454545454,0.36363636363636365
aueG4G7BdVs,4,17,3,24,0.16666666666666666,0.16666666666666666,0.7083333333333334
avfagyitpu4,12,2,1,15,0.8,0.8,0.13333333333333333
awEI9gXjsTc,2,2,0,4,0.5,0.5,0.5
ayso5Uz993U,68,37,7,112,0.6071428571428571,0.6071428571428571,0.33035714285714285
ayyaAfgaK0A,29,18,2,49,0.5918367346938775,0.5918367346938775,0.3673469387755102
azPan5qvWMs,3,8,4,15,0.2,0.2,0.5333333333333333
b0yBoOkycCI,5,10,0,15,0.3333333333333333,0.3333333333333333,0.6666666666666666
b164jynj5UQ,9,14,0,23,0.391304347826087,0.391304347826087,0.6086956521739131
b2P11ihvxpw,32,10,5,47,0.6808510638297872,0.6808510638297872,0.2127659574468085
b2bAF41huNk,33,72,4,109,0.30275229357798167,0.30275229357798167,0.6605504587155964
b2w1fRGw700,2,9,1,12,0.16666666666666666,0.16666666666666666,0.75
b3ktGGKkBEE,2,12,1,15,0.13333333333333333,0.13333333333333333,0.8
b3vZInPMlYs,13,66,2,81,0.16049382716049382,0.16049382716049382,0.8148148148148148
b4dajLzS0iQ,112,159,17,288,0.3888888888888889,0.3888888888888889,0.5520833333333334
b5DjFNTmtjY,9,18,3,30,0.3,0.3,0.6
b5OQJqgcjjo,23,6,1,30,0.7666666666666667,0.7666666666666667,0.2
b854u-GiOIc,5,31,3,39,0.1282051282051282,0.1282051282051282,0.7948717948717948
b9EQFIX7f3k,20,23,0,43,0.46511627906976744,0.46511627906976744,0.5348837209302325
b9SE9zrd1po,23,13,2,38,0.6052631578947368,0.6052631578947368,0.34210526315789475
bBP4AL4Hn1k,40,32,5,77,0.5194805194805194,0.5194805194805194,0.4155844155844156
bBpRGa38eHY,24,19,2,45,0.5333333333333333,0.5333333333333333,0.4222222222222222
bC-fOkfU2rQ,22,44,9,75,0.29333333333333333,0.29333333333333333,0.5866666666666667
bDUY4cy8IRI,2,1,0,3,0.6666666666666666,0.6666666666666666,0.3333333333333333
bHP-NaJLUrY,13,63,13,89,0.14606741573033707,0.14606741573033707,0.7078651685393258
bI3GuCugj8w,151,81,11,243,0.6213991769547325,0.6213991769547325,0.3333333333333333
bIqsu6sgTnQ,16,63,8,87,0.1839080459770115,0.1839080459770115,0.7241379310344828
bKO05NGxJ20,15,48,2,65,0.23076923076923078,0.23076923076923078,0.7384615384615385
bMv20Q76_iA,3,5,0,8,0.375,0.375,0.625
bN-ucs4aSYE,35,39,7,81,0.43209876543209874,0.43209876543209874,0.48148148148148145
bNVYThFC140,33,169,12,214,0.1542056074766355,0.1542056074766355,0.7897196261682243
bNoCDSI1rBA,2,21,4,27,0.07407407407407407,0.07407407407407407,0.7777777777777778
bO-LbSi-CmM,5,39,0,44,0.11363636363636363,0.11363636363636363,0.8863636363636364
bP-TLd19YF8,0,1,0,1,0,0,1
bQUaKqpFj4o,2,3,0,5,0.4,0.4,0.6
bQZZoxDRAJ8,42,137,11,190,0.22105263157894736,0.22105263157894736,0.7210526315789474
bQfCyoFuhMQ,6,35,6,47,0.1276595744680851,0.1276595744680851,0.7446808510638298
bR612M1IrYA,68,57,5,130,0.5230769230769231,0.5230769230769231,0.43846153846153846
bWIq9A6XE_E,6,30,3,39,0.15384615384615385,0.15384615384615385,0.7692307692307693
bW_pkPFQLys,39,14,3,56,0.6964285714285714,0.6964285714285714,0.25
bcCop8L_BAY,45,200,16,261,0.1724137931034483,0.1724137931034483,0.7662835249042146
bdUGsTr45JY,3,8,1,12,0.25,0.25,0.6666666666666666
be-nK0J_bos,14,6,0,20,0.7,0.7,0.3
bekJxw7-lBQ,9,23,2,34,0.2647058823529412,0.2647058823529412,0.6764705882352942
bfh0OG8YuYI,10,12,1,23,0.43478260869565216,0.43478260869565216,0.5217391304347826
bgvsFPFN-o4,38,36,6,80,0.475,0.475,0.45
bj785mgD4B4,164,86,30,280,0.5857142857142857,0.5857142857142857,0.30714285714285716
bjrptLefNF4,1,31,5,37,0.02702702702702703,0.02702702702702703,0.8378378378378378
bn0kRDAzvZY,7,10,2,19,0.3684210526315789,0.3684210526315789,0.5263157894736842
boX4J_X9_RE,21,37,4,62,0.3387096774193548,0.3387096774193548,0.5967741935483871
boklw-G3sIA,12,35,2,49,0.24489795918367346,0.24489795918367346,0.7142857142857143
bpf8KZwWNUo,6,7,0,13,0.46153846153846156,0.46153846153846156,0.5384615384615384
bpi_XgTkXuE,1,7,2,10,0.1,0.1,0.7
bpm9C3ddwEE,30,53,0,83,0.3614457831325301,0.3614457831325301,0.6385542168674698
bqLVTAjv9kA,22,13,2,37,0.5945945945945946,0.5945945945945946,0.35135135135135137
bsFkt4_25Z0,34,159,11,204,0.16666666666666666,0.16666666666666666,0.7794117647058824
bsVZUzHl6UU,57,48,9,114,0.5,0.5,0.42105263157894735
bsjKUJ9nEwg,6,7,1,14,0.42857142857142855,0.42857142857142855,0.5
bsrE89GkG9c,14,21,8,43,0.32558139534883723,0.32558139534883723,0.4883720930232558
buMFC67Scxg,22,45,4,71,0.30985915492957744,0.30985915492957744,0.6338028169014085
bww6PmOb4r4,42,61,4,107,0.3925233644859813,0.3925233644859813,0.5700934579439252
bxqfh6QBODs,18,16,3,37,0.4864864864864865,0.4864864864864865,0.43243243243243246
byjQQu4RUew,13,9,1,23,0.5652173913043478,0.5652173913043478,0.391304347826087
byrr7EULnEM,9,3,0,12,0.75,0.75,0.25
c0L7DIrWP0A,12,34,1,47,0.2553191489361702,0.2553191489361702,0.723404255319149
c0nvu0rQsew,4,6,0,10,0.4,0.4,0.6
c1UgPS6OT30,15,64,8,87,0.1724137931034483,0.1724137931034483,0.735632183908046
c1rdhEIFXog,14,10,2,26,0.5384615384615384,0.5384615384615384,0.38461538461538464
c2A7kmWYp8I,9,34,8,51,0.17647058823529413,0.17647058823529413,0.6666666666666666
c39XsGC_fWM,58,68,5,131,0.44274809160305345,0.44274809160305345,0.5190839694656488
c40eOd57_oA,17,22,1,40,0.425,0.425,0.55
c48A8oR0ibI,8,23,4,35,0.22857142857142856,0.22857142857142856,0.6571428571428571
c5arXlWB9tE,2,6,0,8,0.25,0.25,0.75
c6JM438ytwE,2,1,3,6,0.3333333333333333,0.3333333333333333,0.16666666666666666
c6pajsFwaHg,7,18,1,26,0.2692307692307692,0.2692307692307692,0.6923076923076923
c6viG0DpMro,131,83,13,227,0.5770925110132159,0.5770925110132159,0.3656387665198238
c96wvDLvfoc,11,3,1,15,0.7333333333333333,0.7333333333333333,0.2
c9RZ269OAOw,21,7,0,28,0.75,0.75,0.25
c9_99_6G79Q,25,14,2,41,0.6097560975609756,0.6097560975609756,0.34146341463414637
cA6ps-haWAM,4,0,2,6,0.6666666666666666,0.6666666666666666,0
cB7Kbu7ugBU,7,11,1,19,0.3684210526315789,0.3684210526315789,0.5789473684210527
cCcq-f1bIWw,11,15,1,27,0.4074074074074074,0.4074074074074074,0.5555555555555556
cEFL6OALfUs,11,10,3,24,0.4583333333333333,0.4583333333333333,0.4166666666666667
cEM_T06vN2g,12,60,1,73,0.1643835616438356,0.1643835616438356,0.821917808219178
cGTEloq5kUw,3,4,0,7,0.42857142857142855,0.42857142857142855,0.5714285714285714
cGjbzagkeEo,3,17,2,22,0.13636363636363635,0.13636363636363635,0.7727272727272727
cH5zezR796E,21,32,0,53,0.39622641509433965,0.39622641509433965,0.6037735849056604
cJzq9g9uG6s,518,801,208,1527,0.3392272429600524,0.3392272429600524,0.5245579567779961
cLHUdFoK9OE,80,53,17,150,0.5333333333333333,0.5333333333333333,0.35333333333333333
cLN5zRKp0kY,25,51,6,82,0.3048780487804878,0.3048780487804878,0.6219512195121951
cLglv78eyDk,5,11,0,16,0.3125,0.3125,0.6875
cMBs0RSs_zg,5,25,3,33,0.15151515151515152,0.15151515151515152,0.7575757575757576
cMrdgXKQauc,12,23,4,39,0.3076923076923077,0.3076923076923077,0.5897435897435898
cNZRvbixomU,18,24,6,48,0.375,0.375,0.5
cNwNt73--JU,68,59,8,135,0.5037037037037037,0.5037037037037037,0.43703703703703706
cNx8aFAp14I,7,7,1,15,0.4666666666666667,0.4666666666666667,0.4666666666666667
cPHhN99LsXE,5,27,3,35,0.14285714285714285,0.14285714285714285,0.7714285714285715
cPgcsLvQTNQ,51,30,6,87,0.5862068965517241,0.5862068965517241,0.3448275862068966
cQ4x7RU4Fo8,35,66,13,114,0.30701754385964913,0.30701754385964913,0.5789473684210527
cQSiC180f1M,23,151,14,188,0.12234042553191489,0.12234042553191489,0.8031914893617021
cRDi-Wt_C0I,7,3,1,11,0.6363636363636364,0.6363636363636364,0.2727272727272727
cSp2EeUyoXc,44,66,5,115,0.3826086956521739,0.3826086956521739,0.5739130434782609
cUdEWYuSAgQ,21,70,2,93,0.22580645161290322,0.22580645161290322,0.7526881720430108
cYIFQl3mDTk,12,21,1,34,0.35294117647058826,0.35294117647058826,0.6176470588235294
cYlnv008p7g,18,36,6,60,0.3,0.3,0.6
c_A0KS_gjPw,33,6,0,39,0.8461538461538461,0.8461538461538461,0.15384615384615385
ca-BsfUdpgM,10,25,1,36,0.2777777777777778,0.2777777777777778,0.6944444444444444
cbCS2UNZLts,12,23,2,37,0.32432432432432434,0.32432432432432434,0.6216216216216216
cb_ojAItV5I,5,10,1,16,0.3125,0.3125,0.625
cbxv_CFH1tQ,8,24,1,33,0.24242424242424243,0.24242424242424243,0.7272727272727273
cdSius1pEDg,14,16,2,32,0.4375,0.4375,0.5
ceMkcRcLXiA,8,8,1,17,0.47058823529411764,0.47058823529411764,0.47058823529411764
cesUDNdF4Yo,2,15,2,19,0.10526315789473684,0.10526315789473684,0.7894736842105263
cfHCU_i3xAM,15,23,1,39,0.38461538461538464,0.38461538461538464,0.5897435897435898
cgcGZd1ZiUc,30,84,16,130,0.23076923076923078,0.23076923076923078,0.6461538461538462
chek74xLlso,10,10,0,20,0.5,0.5,0.5
cjRQtL1NqII,11,29,3,43,0.2558139534883721,0.2558139534883721,0.6744186046511628
ckyxIGo07Bs,9,86,10,105,0.08571428571428572,0.08571428571428572,0.819047619047619
clIOBTLs9yw,36,63,13,112,0.32142857142857145,0.32142857142857145,0.5625
cmI8L4TYdME,7,13,2,22,0.3181818181818182,0.3181818181818182,0.5909090909090909
coIyuahkvaE,32,40,6,78,0.41025641025641024,0.41025641025641024,0.5128205128205128
cojpaVE4fDg,3,9,1,13,0.23076923076923078,0.23076923076923078,0.6923076923076923
cojwJ_Xpe8k,149,510,50,709,0.21015514809590974,0.21015514809590974,0.7193229901269393
cp52iP7C9p8,14,51,6,71,0.19718309859154928,0.19718309859154928,0.7183098591549296
cpWJL-xxtng,21,14,3,38,0.5526315789473685,0.5526315789473685,0.3684210526315789
cqxUiFEGzI8,3,21,4,28,0.10714285714285714,0.10714285714285714,0.75
crsx-2zsgqE,71,214,20,305,0.23278688524590163,0.23278688524590163,0.7016393442622951
ctXQyKDdZVY,4,21,2,27,0.14814814814814814,0.14814814814814814,0.7777777777777778
cvjW1Jxvl0k,23,53,1,77,0.2987012987012987,0.2987012987012987,0.6883116883116883
cvkWK-Lnwgw,10,7,0,17,0.5882352941176471,0.5882352941176471,0.4117647058823529
cvy9Bj0ltNg,3,4,1,8,0.375,0.375,0.5
cw0OhmElWCc,23,20,2,45,0.5111111111111111,0.5111111111111111,0.4444444444444444
cwKa5hwsCUo,5,16,1,22,0.22727272727272727,0.22727272727272727,0.7272727272727273
cxcBRHC50dQ,15,18,2,35,0.42857142857142855,0.42857142857142855,0.5142857142857142
cxrzhbSNF_4,47,154,15,216,0.2175925925925926,0.2175925925925926,0.7129629629629629
cylWpghnLMs,3,3,1,7,0.42857142857142855,0.42857142857142855,0.42857142857142855
czaFLXD6zfE,6,9,1,16,0.375,0.375,0.5625
d-xLm83ESTs,18,25,2,45,0.4,0.4,0.5555555555555556
d19n2Iy5xpU,205,22,7,234,0.8760683760683761,0.8760683760683761,0.09401709401709402
d1SYZhWrVOg,80,126,8,214,0.37383177570093457,0.37383177570093457,0.5887850467289719
d1uqqez5w_E,17,12,1,30,0.5666666666666667,0.5666666666666667,0.4
d2TOl_3y_5s,9,43,1,53,0.16981132075471697,0.16981132075471697,0.8113207547169812
d38uqECajso,7,12,1,20,0.35,0.35,0.6
d4insbB6gEU,2,0,0,2,1,1,0
d5Kpi775xa8,1,4,0,5,0.2,0.2,0.8
d7hqYGXy3MU,17,51,5,73,0.2328767123287671,0.2328767123287671,0.6986301369863014
d95KhFH1fCo,4,5,1,10,0.4,0.4,0.5
dASptqWdt1c,7,4,0,11,0.6363636363636364,0.6363636363636364,0.36363636363636365
dCMI36A0Fvo,4,10,2,16,0.25,0.25,0.625
dCpWI3wWXpQ,4,4,1,9,0.4444444444444444,0.4444444444444444,0.4444444444444444
dDEXVfcF4kQ,6,49,10,65,0.09230769230769231,0.09230769230769231,0.7538461538461538
dDQkb7GDEGQ,1,8,1,10,0.1,0.1,0.8
dErBkWDD05g,30,15,4,49,0.6122448979591837,0.6122448979591837,0.30612244897959184
dF7p4iRns9Q,14,47,9,70,0.2,0.2,0.6714285714285714
dFg5eM9uKso,6,13,1,20,0.3,0.3,0.65
dFzljw6uH8Y,177,177,32,386,0.4585492227979275,0.4585492227979275,0.4585492227979275
dGaJ3ufOiz4,15,26,0,41,0.36585365853658536,0.36585365853658536,0.6341463414634146
dHTlCcU-bVY,294,226,66,586,0.5017064846416383,0.5017064846416383,0.38566552901023893
dI08Joj8pKI,19,41,2,62,0.3064516129032258,0.3064516129032258,0.6612903225806451
dIqj9es-vLg,2,9,2,13,0.15384615384615385,0.15384615384615385,0.6923076923076923
dKLxa6O_3Vs,1,1,1,3,0.3333333333333333,0.3333333333333333,0.3333333333333333
dKSHZgJC_t8,2,0,0,2,1,1,0
dMapG-TzyRM,17,7,0,24,0.7083333333333334,0.7083333333333334,0.2916666666666667
dNoXApRHqGQ,9,20,0,29,0.3103448275862069,0.3103448275862069,0.6896551724137931
dNqMR33EIbs,229,124,5,358,0.6396648044692738,0.6396648044692738,0.3463687150837989
dPvC7aR0X8E,23,41,9,73,0.3150684931506849,0.3150684931506849,0.5616438356164384
dQHN2gIqjaA,5,11,1,17,0.29411764705882354,0.29411764705882354,0.6470588235294118
dSGoeQXOXTc,5,6,0,11,0.45454545454545453,0.45454545454545453,0.5454545454545454
dSHbC5BLUEo,18,26,0,44,0.4090909090909091,0.4090909090909091,0.5909090909090909
dTDqhzcyO1w,217,206,29,452,0.48008849557522126,0.48008849557522126,0.4557522123893805
dUm136wZMKo,71,43,6,120,0.5916666666666667,0.5916666666666667,0.35833333333333334
dV5r0lPj4X4,30,13,2,45,0.6666666666666666,0.6666666666666666,0.28888888888888886
dXNGdFdHSYA,15,10,4,29,0.5172413793103449,0.5172413793103449,0.3448275862068966
dXXEpKR-huQ,93,166,9,268,0.34701492537313433,0.34701492537313433,0.6194029850746269
dXl8ReTrEfk,7,16,2,25,0.28,0.28,0.64
dYJgQVqA-bk,16,16,1,33,0.48484848484848486,0.48484848484848486,0.48484848484848486
dZXenXiOvOE,9,20,1,30,0.3,0.3,0.6666666666666666
daD73HSwxlI,11,17,5,33,0.3333333333333333,0.3333333333333333,0.5151515151515151
dbeEecHr66Q,6,19,0,25,0.24,0.24,0.76
dbp5okmAQhk,8,16,2,26,0.3076923076923077,0.3076923076923077,0.6153846153846154
dcBiXg7zTKY,12,46,4,62,0.1935483870967742,0.1935483870967742,0.7419354838709677
dcJkyz45Bb4,20,24,2,46,0.43478260869565216,0.43478260869565216,0.5217391304347826
dcUF3V9KMKw,20,17,1,38,0.5263157894736842,0.5263157894736842,0.4473684210526316
dcevzHNS6fw,17,71,5,93,0.1827956989247312,0.1827956989247312,0.7634408602150538
deyPvrjLOMA,7,67,3,77,0.09090909090909091,0.09090909090909091,0.8701298701298701
dfQqsCfA2OI,5,20,3,28,0.17857142857142858,0.17857142857142858,0.7142857142857143
dgn7BytcSFc,2,3,0,5,0.4,0.4,0.6
dha7v1LgVVY,5,9,1,15,0.3333333333333333,0.3333333333333333,0.6
djiPJnQyyr0,89,51,8,148,0.6013513513513513,0.6013513513513513,0.34459459459459457
dkTo-H2iKa0,13,39,12,64,0.203125,0.203125,0.609375
dlxUn_DqTLA,18,7,6,31,0.5806451612903226,0.5806451612903226,0.22580645161290322
dmxdfSgGSig,12,34,2,48,0.25,0.25,0.7083333333333334
dn0TqLEBra4,7,22,0,29,0.2413793103448276,0.2413793103448276,0.7586206896551724
dnA7wK-v2uA,25,95,7,127,0.1968503937007874,0.1968503937007874,0.7480314960629921
dpTYDqT2y5s,12,61,11,84,0.14285714285714285,0.14285714285714285,0.7261904761904762
dpwBZZKZLDg,10,18,1,29,0.3448275862068966,0.3448275862068966,0.6206896551724138
dqrLm54dPCo,16,31,4,51,0.3137254901960784,0.3137254901960784,0.6078431372549019
dr8jPg_8d5k,24,10,2,36,0.6666666666666666,0.6666666666666666,0.2777777777777778
drJUmeQ5p4A,8,26,6,40,0.2,0.2,0.65
dsS-xhkaY7s,75,22,1,98,0.7653061224489796,0.7653061224489796,0.22448979591836735
dvpk_BT2D0A,19,12,3,34,0.5588235294117647,0.5588235294117647,0.35294117647058826
dxVtZ00o9DQ,31,29,6,66,0.4696969696969697,0.4696969696969697,0.4393939393939394
dxxqxIdRJGA,9,6,2,17,0.5294117647058824,0.5294117647058824,0.35294117647058826
dymADWtCp5A,11,23,1,35,0.3142857142857143,0.3142857142857143,0.6571428571428571
dzYSBzxWKXI,8,21,3,32,0.25,0.25,0.65625
e-9e5GP70jM,20,16,4,40,0.5,0.5,0.4
e-S5U8zxyD0,2,23,2,27,0.07407407407407407,0.07407407407407407,0.8518518518518519
e-mAc64P1_k,17,11,1,29,0.5862068965517241,0.5862068965517241,0.3793103448275862
e0B0FLf5jwc,4,20,2,26,0.15384615384615385,0.15384615384615385,0.7692307692307693
e0JlGaDDkts,13,7,1,21,0.6190476190476191,0.6190476190476191,0.3333333333333333
e0TSNVeKjF0,344,197,50,591,0.5820642978003384,0.5820642978003384,0.3333333333333333
e20hU2E6Swk,40,24,1,65,0.6153846153846154,0.6153846153846154,0.36923076923076925
e30NrMmCNXI,0,3,0,3,0,0,1
e4_Oe-wJRig,12,17,2,31,0.3870967741935484,0.3870967741935484,0.5483870967741935
e5-QiMuSd_g,11,43,1,55,0.2,0.2,0.7818181818181819
e6or4PARGJU,8,32,0,40,0.2,0.2,0.8
e70N2w6GWNE,39,149,11,199,0.19597989949748743,0.19597989949748743,0.7487437185929648
e74GeY0AKYs,0,4,0,4,0,0,1
e7U7fa48sk8,43,91,5,139,0.30935251798561153,0.30935251798561153,0.6546762589928058
e7U93i-ThiM,9,17,4,30,0.3,0.3,0.5666666666666667
e7qvghD2nu4,42,29,9,80,0.525,0.525,0.3625
e8lER97JJYg,7,12,1,20,0.35,0.35,0.6
e94GuJt6xeE,4,9,2,15,0.26666666666666666,0.26666666666666666,0.6
e96b2OsMeqc,3,6,0,9,0.3333333333333333,0.3333333333333333,0.6666666666666666
e9TyWgCwDKs,3,12,0,15,0.2,0.2,0.8
e9xHURJfrl4,4,7,1,12,0.3333333333333333,0.3333333333333333,0.5833333333333334
eD5CL3fwVt8,48,18,4,70,0.6857142857142857,0.6857142857142857,0.2571428571428571
eDE8gs3nawo,21,9,0,30,0.7,0.7,0.3
eDoQd4cUZr0,0,1,0,1,0,0,1
eFSb-97Hg90,12,6,1,19,0.631578947368421,0.631578947368421,0.3157894736842105
eGiA02NM8rM,3,18,0,21,0.14285714285714285,0.14285714285714285,0.8571428571428571
eIP01YbYJAI,4,9,0,13,0.3076923076923077,0.3076923076923077,0.6923076923076923
eJQIYjNT-Xs,2,10,2,14,0.14285714285714285,0.14285714285714285,0.7142857142857143
eJn603nHU_0,1,10,0,11,0.09090909090909091,0.09090909090909091,0.9090909090909091
eLtptKl6ZKM,5,7,1,13,0.38461538461538464,0.38461538461538464,0.5384615384615384
eNb_FNO_Gwk,4,6,2,12,0.3333333333333333,0.3333333333333333,0.5
eS_USiLCfVM,21,19,6,46,0.45652173913043476,0.45652173913043476,0.41304347826086957
eSwF-8bvYzs,13,22,1,36,0.3611111111111111,0.3611111111111111,0.6111111111111112
eT3_IcePsiA,41,32,4,77,0.5324675324675324,0.5324675324675324,0.4155844155844156
eTpdn8afvMI,59,121,11,191,0.3089005235602094,0.3089005235602094,0.6335078534031413
eV5Rdz7B5-U,87,126,24,237,0.3670886075949367,0.3670886075949367,0.5316455696202531
eVD6oiX71zs,12,8,1,21,0.5714285714285714,0.5714285714285714,0.38095238095238093
eVRN6m2wXdo,8,17,1,26,0.3076923076923077,0.3076923076923077,0.6538461538461539
eVsNR3Kp5bs,7,10,1,18,0.3888888888888889,0.3888888888888889,0.5555555555555556
eZJXbH1RY6M,16,14,3,33,0.48484848484848486,0.48484848484848486,0.42424242424242425
e_cDXS7o03M,4,10,1,15,0.26666666666666666,0.26666666666666666,0.6666666666666666
eaNMhXwEyUs,64,446,10,520,0.12307692307692308,0.12307692307692308,0.8576923076923076
edGOWeOt-CQ,13,25,2,40,0.325,0.325,0.625
eeb_4k-_TvM,9,14,1,24,0.375,0.375,0.5833333333333334
eezvKT5AXU8,10,7,2,19,0.5263157894736842,0.5263157894736842,0.3684210526315789
ef2vUDVkemg,4,19,4,27,0.14814814814814814,0.14814814814814814,0.7037037037037037
efzATiWr_cg,5,12,1,18,0.2777777777777778,0.2777777777777778,0.6666666666666666
egsAM6rW2vo,37,13,3,53,0.6981132075471698,0.6981132075471698,0.24528301886792453
ehYNKon6k_A,27,46,7,80,0.3375,0.3375,0.575
ehbQXhHfsII,24,7,0,31,0.7741935483870968,0.7741935483870968,0.22580645161290322
ehdLmgbPOGk,16,18,2,36,0.4444444444444444,0.4444444444444444,0.5
eiRxYTIH6lY,7,0,1,8,0.875,0.875,0
eiku_onBcmg,3,26,4,33,0.09090909090909091,0.09090909090909091,0.7878787878787878
ejExMQtMwGs,4,12,1,17,0.23529411764705882,0.23529411764705882,0.7058823529411765
ek3HYtyYDFU,44,67,14,125,0.352,0.352,0.536
eozlYXaNo8E,12,83,3,98,0.12244897959183673,0.12244897959183673,0.8469387755102041
epXYI6FEJcY,265,695,137,1097,0.2415679124886053,0.2415679124886053,0.6335460346399271
esEP25QsdSU,1,6,1,8,0.125,0.125,0.75
evphGYQfbWw,56,55,6,117,0.47863247863247865,0.47863247863247865,0.4700854700854701
ew1JCVvjexQ,17,22,9,48,0.3541666666666667,0.3541666666666667,0.4583333333333333
ex19f7TQErM,15,37,1,53,0.2830188679245283,0.2830188679245283,0.6981132075471698
exalb4DvspY,36,18,3,57,0.631578947368421,0.631578947368421,0.3157894736842105
ey2-PalbcdA,7,13,3,23,0.30434782608695654,0.30434782608695654,0.5652173913043478
ezmGTZqhXuI,16,69,6,91,0.17582417582417584,0.17582417582417584,0.7582417582417582
f-dm4dFNOXM,35,27,4,66,0.5303030303030303,0.5303030303030303,0.4090909090909091
f-uKgibLx_g,2,18,2,22,0.09090909090909091,0.09090909090909091,0.8181818181818182
f2CoE4kHn50,18,45,7,70,0.2571428571428571,0.2571428571428571,0.6428571428571429
f32XpO1jeIQ,10,38,0,48,0.20833333333333334,0.20833333333333334,0.7916666666666666
f44AclX0bkk,6,11,0,17,0.35294117647058826,0.35294117647058826,0.6470588235294118
f4QenyIkMvw,14,65,3,82,0.17073170731707318,0.17073170731707318,0.7926829268292683
f5Vq-Z4t66Y,15,72,1,88,0.17045454545454544,0.17045454545454544,0.8181818181818182
f5loeYPbZv4,62,56,4,122,0.5081967213114754,0.5081967213114754,0.45901639344262296
f6TJ_VgJZbM,16,22,7,45,0.35555555555555557,0.35555555555555557,0.4888888888888889
f94BsSxuNLw,3,10,1,14,0.21428571428571427,0.21428571428571427,0.7142857142857143
f9CSLrSu6rM,43,141,5,189,0.2275132275132275,0.2275132275132275,0.746031746031746
f9UZPlDbVfY,4,14,1,19,0.21052631578947367,0.21052631578947367,0.7368421052631579
fAQny7IMXl4,41,63,6,110,0.37272727272727274,0.37272727272727274,0.5727272727272728
fAv2rUeBBkM,7,20,1,28,0.25,0.25,0.7142857142857143
fBvM8ovaRBU,10,23,1,34,0.29411764705882354,0.29411764705882354,0.6764705882352942
fBz5CXiCo9k,13,31,0,44,0.29545454545454547,0.29545454545454547,0.7045454545454546
fCPdrfesLjc,6,7,1,14,0.42857142857142855,0.42857142857142855,0.5
fEN5vMrFlUw,2,0,0,2,1,1,0
fFStTO3lctU,3,15,1,19,0.15789473684210525,0.15789473684210525,0.7894736842105263
fHl3idi2pOQ,179,113,20,312,0.5737179487179487,0.5737179487179487,0.36217948717948717
fHqumeLdODI,11,37,3,51,0.21568627450980393,0.21568627450980393,0.7254901960784313
fHxFOZTPZ_Q,9,26,3,38,0.23684210526315788,0.23684210526315788,0.6842105263157895
fJ477SanbQU,24,42,3,69,0.34782608695652173,0.34782608695652173,0.6086956521739131
fKJAv7WRSbw,1,1,0,2,0.5,0.5,0.5
fKl6RbqZbMc,49,143,15,207,0.23671497584541062,0.23671497584541062,0.6908212560386473
fLXmIRS51ok,7,15,1,23,0.30434782608695654,0.30434782608695654,0.6521739130434783
fM8WZkYn8wo,13,35,1,49,0.2653061224489796,0.2653061224489796,0.7142857142857143
fMQ_dUNpky8,10,6,2,18,0.5555555555555556,0.5555555555555556,0.3333333333333333
fOPClINDClM,19,18,4,41,0.4634146341463415,0.4634146341463415,0.43902439024390244
fQyQMCT18Ic,1,3,0,4,0.25,0.25,0.75
fRiW09fCtM8,2,7,0,9,0.2222222222222222,0.2222222222222222,0.7777777777777778
fRkAFd4c2vI,11,38,4,53,0.20754716981132076,0.20754716981132076,0.71698113207547165
fSUdmt1L1dY,14,60,6,80,0.175,0.175,0.75
fShX1waHBXU,50,199,26,275,0.18181818181818182,0.18181818181818182,0.7236363636363636
fWz7Q-BgcWs,47,62,7,116,0.4051724137931034,0.4051724137931034,0.5344827586206896
fYWiuUua2gc,35,28,1,64,0.546875,0.546875,0.4375
f_9-30FhAjE,26,95,12,133,0.19548872180451127,0.19548872180451127,0.7142857142857143
f_ctorSI34c,8,19,0,27,0.2962962962962963,0.2962962962962963,0.7037037037037037
f_hAFaHu678,16,27,1,44,0.36363636363636365,0.36363636363636365,0.6136363636363636
fa8JzevgPSQ,3,11,2,16,0.1875,0.1875,0.6875
faHuK94NQcw,73,287,24,384,0.19010416666666666,0.19010416666666666,0.7473958333333334
faxDK6gEH2Q,8,11,1,20,0.4,0.4,0.55
fbHiSBnWBHI,11,6,0,17,0.6470588235294118,0.6470588235294118,0.35294117647058826
fc7j9MCKZLs,33,35,3,71,0.4647887323943662,0.4647887323943662,0.49295774647887325
fcu6OGW5lYA,2,13,2,17,0.11764705882352941,0.11764705882352941,0.7647058823529411
fdKyHwXpQ1A,11,63,5,79,0.13924050632911392,0.13924050632911392,0.7974683544303798
ffAKk2_N47E,11,81,4,96,0.11458333333333333,0.11458333333333333,0.84375
ffEqnKBvw8U,6,12,0,18,0.3333333333333333,0.3333333333333333,0.6666666666666666
fhM2PdWiJMQ,10,29,4,43,0.23255813953488372,0.23255813953488372,0.6744186046511628
fhN0Jc9mW9o,12,52,2,66,0.18181818181818182,0.18181818181818182,0.7878787878787878
fhkDtCjipDU,7,2,3,12,0.5833333333333334,0.5833333333333334,0.16666666666666666
fhpGg98TOGE,1,1,0,2,0.5,0.5,0.5
fijXZQmGufk,14,63,8,85,0.16470588235294117,0.16470588235294117,0.7411764705882353
fjxV-AjxwKU,4,24,1,29,0.13793103448275862,0.13793103448275862,0.8275862068965517
fkTnHXlZi5A,105,92,12,209,0.5023923444976076,0.5023923444976076,0.44019138755980863
foICDfEAFq4,17,42,8,67,0.2537313432835821,0.2537313432835821,0.6268656716417911
fpEoNW0ImQE,3,18,2,23,0.13043478260869565,0.13043478260869565,0.782608695652174
fpPRBorGiW0,26,92,10,128,0.203125,0.203125,0.71875
fq5e0hEkZmM,3,0,0,3,1,1,0
fqTlY_EntVo,3,15,1,19,0.15789473684210525,0.15789473684210525,0.7894736842105263
fs3eQYbikZU,9,22,0,31,0.2903225806451613,0.2903225806451613,0.7096774193548387
fssCHPBhuoA,4,11,0,15,0.26666666666666666,0.26666666666666666,0.7333333333333333
ftA5yu4KfAs,79,102,21,202,0.3910891089108911,0.3910891089108911,0.504950495049505
ftiwdLdItyQ,29,27,4,60,0.48333333333333334,0.48333333333333334,0.45
fuRINUNllBQ,114,184,13,311,0.3665594855305466,0.3665594855305466,0.5916398713826366
fw7G00WxhFw,21,13,5,39,0.5384615384615384,0.5384615384615384,0.3333333333333333
fwSP6u5LLnc,11,11,2,24,0.4583333333333333,0.4583333333333333,0.4583333333333333
fwd1NFI5Efw,14,49,6,69,0.2028985507246377,0.2028985507246377,0.7101449275362319
fxBXy1BURYQ,2,4,0,6,0.3333333333333333,0.3333333333333333,0.6666666666666666
g01tWfG-1To,120,294,46,460,0.2608695652173913,0.2608695652173913,0.6391304347826087
g25B2IleLzE,22,15,2,39,0.5641025641025641,0.5641025641025641,0.38461538461538464
g2Mq-PUou2s,6,13,2,21,0.2857142857142857,0.2857142857142857,0.6190476190476191
g2k9vCzz5FE,3,5,1,9,0.3333333333333333,0.3333333333333333,0.5555555555555556
g4XFVXgObS8,2061,1051,139,3251,0.6339587819132575,0.6339587819132575,0.32328514303291295
g4o1l7oagms,9,21,2,32,0.28125,0.28125,0.65625
g5eaN3DBV7g,30,161,15,206,0.14563106796116504,0.14563106796116504,0.7815533980582524
g5nCmLPVndA,35,61,1,97,0.36082474226804123,0.36082474226804123,0.6288659793814433
g72c7GSRW8c,22,57,4,83,0.26506024096385544,0.26506024096385544,0.6867469879518072
g7T8cRd1WLw,52,199,27,278,0.18705035971223022,0.18705035971223022,0.7158273381294964
g7hTUlo0u9A,5,3,0,8,0.625,0.625,0.375
gAnyhlccP-w,11,34,4,49,0.22448979591836735,0.22448979591836735,0.6938775510204082
gBoeYwlVQu8,38,37,4,79,0.4810126582278481,0.4810126582278481,0.46835443037974683
gCXRX2I5vk4,17,30,6,53,0.32075471698113206,0.32075471698113206,0.5660377358490566
gCnsE3Uk_tE,25,30,4,59,0.423728813559322,0.423728813559322,0.5084745762711864
gCrdRWr16sY,0,7,2,9,0,0,0.7777777777777778
gElEjY3hNcs,6,5,0,11,0.5454545454545454,0.5454545454545454,0.45454545454545453
gFbXkXPycRU,11,4,1,16,0.6875,0.6875,0.25
gFl68yzJ3wE,0,1,1,2,0,0,0.5
gGHOztm-qog,23,10,2,35,0.6571428571428571,0.6571428571428571,0.2857142857142857
gHRvBSFru2M,91,164,35,290,0.3137931034482759,0.3137931034482759,0.5655172413793104
gIiV7xLWso4,13,4,0,17,0.7647058823529411,0.7647058823529411,0.23529411764705882
gJHN2tAW_jM,6,9,1,16,0.375,0.375,0.5625
gLjyegXYz04,23,43,3,69,0.3333333333333333,0.3333333333333333,0.6231884057971014
gOVcfBOh6Xs,62,23,3,88,0.7045454545454546,0.7045454545454546,0.26136363636363635
gRJumlIxuK0,31,35,3,69,0.4492753623188406,0.4492753623188406,0.5072463768115942
gTSiFdmvZu0,8,9,0,17,0.47058823529411764,0.47058823529411764,0.5294117647058824
gT_tIy2fZOs,28,30,3,61,0.45901639344262296,0.45901639344262296,0.4918032786885246
gTs9Vmkyeeg,7,19,0,26,0.2692307692307692,0.2692307692307692,0.7307692307692307
gUCWZy_s_wQ,11,28,3,42,0.2619047619047619,0.2619047619047619,0.6666666666666666
gVQjb9oULok,3,3,1,7,0.42857142857142855,0.42857142857142855,0.42857142857142855
gVU3LOfKd58,78,236,20,334,0.23353293413173654,0.23353293413173654,0.7065868263473054
gVbfKT2qX5I,12,25,2,39,0.3076923076923077,0.3076923076923077,0.6410256410256411
gVfU7YLFuc8,132,164,16,312,0.4230769230769231,0.4230769230769231,0.5256410256410257
gW8jqcEQJ38,13,44,1,58,0.22413793103448276,0.22413793103448276,0.7586206896551724
gWUGmokfjGs,17,38,3,58,0.29310344827586204,0.29310344827586204,0.6551724137931034
gXOV1U_pqQU,6,9,3,18,0.3333333333333333,0.3333333333333333,0.5
gXP5Uvdxi9A,4,17,2,23,0.17391304347826086,0.17391304347826086,0.7391304347826086
gYe9E0D5udo,335,681,34,1050,0.319047619047619,0.319047619047619,0.6485714285714286
gZ5Uup61EbQ,84,102,21,207,0.4057971014492754,0.4057971014492754,0.4927536231884058
ga8pHQOqLbM,10,69,3,82,0.12195121951219512,0.12195121951219512,0.8414634146341463
gd91aY2lyXA,20,21,3,44,0.45454545454545453,0.45454545454545453,0.4772727272727273
geUF54WBnHE,15,15,0,30,0.5,0.5,0.5
gfwdUkUdgK8,19,15,6,40,0.475,0.475,0.375
ggpGYT8rT3Y,10,61,6,77,0.12987012987012986,0.12987012987012986,0.7922077922077922
gjE8J1kCBus,17,20,4,41,0.4146341463414634,0.4146341463414634,0.4878048780487805
gjfVLK9GWrI,15,19,1,35,0.42857142857142855,0.42857142857142855,0.5428571428571428
gjzq0EriA4U,7,11,2,20,0.35,0.35,0.55
gjzt20oCwjc,25,106,12,143,0.17482517482517482,0.17482517482517482,0.7412587412587412
gmgik_rlS08,8,15,3,26,0.3076923076923077,0.3076923076923077,0.5769230769230769
gqe-73B3p64,60,50,23,133,0.45112781954887216,0.45112781954887216,0.37593984962406013
gqmIKjc_qls,6,27,4,37,0.16216216216216217,0.16216216216216217,0.7297297297297297
gsK1kbRI-vU,6,8,1,15,0.4,0.4,0.5333333333333333
gsPGXbuuAUw,6,7,1,14,0.42857142857142855,0.42857142857142855,0.5
gsg_DFU6xes,31,135,8,174,0.1781609195402299,0.1781609195402299,0.7758620689655172
gszZ_eKwc3M,2,7,1,10,0.2,0.2,0.7
guBgD8bGst8,83,194,20,297,0.27946127946127947,0.27946127946127947,0.6531986531986532
gvoxAWMAXdc,1,12,0,13,0.07692307692307693,0.07692307692307693,0.9230769230769231
gwLjT1u7qw8,2,1,0,3,0.6666666666666666,0.6666666666666666,0.3333333333333333
gxBjDTxMXIA,22,36,3,61,0.36065573770491804,0.36065573770491804,0.5901639344262295
gy8x_JsQV5c,18,41,5,64,0.28125,0.28125,0.640625
gyZNMCjmH2c,7,1,2,10,0.7,0.7,0.1
gzoXEnixCZw,11,27,0,38,0.2894736842105263,0.2894736842105263,0.7105263157894737
h-bI90cHVWM,366,1134,200,1700,0.21529411764705883,0.21529411764705883,0.6670588235294118
h-vCzsJVsr0,1,13,2,16,0.0625,0.0625,0.8125
h2HZK0-pbSc,12,31,4,47,0.2553191489361702,0.2553191489361702,0.6595744680851063
h3Ur94AVqLY,2,13,3,18,0.1111111111111111,0.1111111111111111,0.7222222222222222
h3xpRVlywWI,19,29,1,49,0.3877551020408163,0.3877551020408163,0.5918367346938775
h56nsaN0waM,32,33,3,68,0.47058823529411764,0.47058823529411764,0.4852941176470588
h5R5AqwRzaE,20,29,6,55,0.36363636363636365,0.36363636363636365,0.5272727272727272
h8lDRPw1Czo,197,146,27,370,0.5324324324324324,0.5324324324324324,0.3945945945945946
h9JjhRagpds,1,1,0,2,0.5,0.5,0.5
h9KDXaOYypI,11,18,2,31,0.3548387096774194,0.3548387096774194,0.5806451612903226
hBugdMvxbCk,20,17,0,37,0.5405405405405406,0.5405405405405406,0.4594594594594595
hEYA2UmKeqE,25,8,2,35,0.7142857142857143,0.7142857142857143,0.22857142857142856
hHCatNiGf5E,5,1,0,6,0.8333333333333334,0.8333333333333334,0.16666666666666666
hIxD9yNH5Qg,14,25,4,43,0.32558139534883723,0.32558139534883723,0.5813953488372093
hKOGf1sWDj0,118,80,15,213,0.5539906103286385,0.5539906103286385,0.3755868544600939
hKr3-wdey4U,9,8,0,17,0.5294117647058824,0.5294117647058824,0.47058823529411764
hLDLOMBC1Do,19,51,4,74,0.25675675675675674,0.25675675675675674,0.6891891891891891
hLH6xzEiSlA,190,112,18,320,0.59375,0.59375,0.35
hO33KWNmYMk,27,41,3,71,0.38028169014084506,0.38028169014084506,0.5774647887323944
hOvZo3CNK4w,10,5,0,15,0.6666666666666666,0.6666666666666666,0.3333333333333333
hPNX7vfkO1g,12,27,1,40,0.3,0.3,0.675
hPYpIfMzcTI,9,18,2,29,0.3103448275862069,0.3103448275862069,0.6206896551724138
hUL5JTIRHi8,9,46,4,59,0.15254237288135594,0.15254237288135594,0.7796610169491526
hUln6r0HyJU,7,6,0,13,0.5384615384615384,0.5384615384615384,0.46153846153846156
hUukJz_gdO0,4,11,3,18,0.2222222222222222,0.2222222222222222,0.6111111111111112
hVlOarTXdJs,6,18,1,25,0.24,0.24,0.72
hWaug2FWtSE,197,555,101,853,0.2309495896834701,0.2309495896834701,0.6506447831184057
hX_aMMWZKqw,41,58,2,101,0.40594059405940597,0.40594059405940597,0.5742574257425742
hYhybuBb_s0,7,5,2,14,0.5,0.5,0.35714285714285715
hZjkqbmn-Nc,4,7,0,11,0.36363636363636365,0.36363636363636365,0.6363636363636364
h_d6h5xQ-Sw,15,29,0,44,0.3409090909090909,0.3409090909090909,0.6590909090909091
h_oO82-yWJo,7,8,2,17,0.4117647058823529,0.4117647058823529,0.47058823529411764
h_v_sgD65J0,15,25,6,46,0.32608695652173914,0.32608695652173914,0.5434782608695652
h_xXugkL48I,6,2,2,10,0.6,0.6,0.2
hb3xDpHFaz0,9,19,1,29,0.3103448275862069,0.3103448275862069,0.6551724137931034
hdKoINCWh_Q,2,13,2,17,0.11764705882352941,0.11764705882352941,0.7647058823529411
hdLS03bXWGk,4,6,0,10,0.4,0.4,0.6
hf3JvVoWc9Y,9,20,1,30,0.3,0.3,0.6666666666666666
hf5eLMz7WAQ,13,10,2,25,0.52,0.52,0.4
hheKJWjHgbM,5,7,2,14,0.35714285714285715,0.35714285714285715,0.5
hiUXHd-YVhU,15,27,6,48,0.3125,0.3125,0.5625
hj77uMHNCX4,22,28,3,53,0.41509433962264153,0.41509433962264153,0.5283018867924528
hkLXbThtDN4,10,6,2,18,0.5555555555555556,0.5555555555555556,0.3333333333333333
hkTDsW3Snx8,6,5,0,11,0.5454545454545454,0.5454545454545454,0.45454545454545453
hmqXrmzNd6M,12,55,7,74,0.16216216216216217,0.16216216216216217,0.7432432432432432
hoJEIk9ern0,12,6,0,18,0.6666666666666666,0.6666666666666666,0.3333333333333333
hphalZ4a9_s,41,178,21,240,0.17083333333333334,0.17083333333333334,0.7416666666666667
hqd_OB02LOo,43,170,10,223,0.19282511210762332,0.19282511210762332,0.7623318385650224
hrKhh31rTiU,20,99,1,120,0.16666666666666666,0.16666666666666666,0.825
hsLwcn2s4fA,7,36,4,47,0.14893617021276595,0.14893617021276595,0.7659574468085106
htyQ3WLVzOk,3,5,0,8,0.375,0.375,0.625
huISJ6LOJ4s,2,3,0,5,0.4,0.4,0.6
hvpCqVqNzoY,5,20,4,29,0.1724137931034483,0.1724137931034483,0.6896551724137931
hwpFicW0W7o,2,13,1,16,0.125,0.125,0.8125
hwyFE0uGESY,31,12,2,45,0.6888888888888889,0.6888888888888889,0.26666666666666666
hySZGgUyVn8,81,44,13,138,0.5869565217391305,0.5869565217391305,0.3188405797101449
hyo3UTNggYQ,3,1,0,4,0.75,0.75,0.25
hyqjKQbWIQw,90,20,1,111,0.8108108108108109,0.8108108108108109,0.18018018018018017
hzysZKV63RQ,8,39,4,51,0.1568627450980392,0.1568627450980392,0.7647058823529411
i0XD3I9DNlA,21,70,6,97,0.21649484536082475,0.21649484536082475,0.7216494845360825
i0iUmv7oSAg,3,20,2,25,0.12,0.12,0.8
i1c9-YMAmPQ,6,24,1,31,0.1935483870967742,0.1935483870967742,0.7741935483870968
i1cQpvQSQ4Q,20,21,0,41,0.4878048780487805,0.4878048780487805,0.5121951219512195
i2EZRFGos7U,5,12,1,18,0.2777777777777778,0.2777777777777778,0.6666666666666666
i2HIJ4tURcc,25,17,1,43,0.5813953488372093,0.5813953488372093,0.3953488372093023
i2OWzY6ve7k,6,6,1,13,0.46153846153846156,0.46153846153846156,0.46153846153846156
i2QCMOVvW7A,2,2,0,4,0.5,0.5,0.5
i4cZPXJdimg,3,6,3,12,0.25,0.25,0.5
i4kH0Jfmy3U,171,142,19,332,0.5150602409638554,0.5150602409638554,0.42771084337349397
i5Qh4cHqscQ,29,30,7,66,0.4393939393939394,0.4393939393939394,0.45454545454545453
i6CAs7wU-nY,11,4,1,16,0.6875,0.6875,0.25
i7AwHFWqIs4,7,9,1,17,0.4117647058823529,0.4117647058823529,0.5294117647058824
i7vvb1qiNik,8,16,1,25,0.32,0.32,0.64
i8KKhzYE5RQ,7,16,0,23,0.30434782608695654,0.30434782608695654,0.6956521739130435
i9F5MVSTKEo,3,5,3,11,0.2727272727272727,0.2727272727272727,0.45454545454545453
i9dW-DUVpH0,3,10,1,14,0.21428571428571427,0.21428571428571427,0.7142857142857143
iAIrir56Dzc,0,2,0,2,0,0,1
iBjsNMCCtJ4,44,28,11,83,0.5301204819277109,0.5301204819277109,0.3373493975903614
iCPHK6PRBO0,35,29,3,67,0.5223880597014925,0.5223880597014925,0.43283582089552236
iCPoTvmxSfY,39,75,6,120,0.325,0.325,0.625
iCT5UF1Invs,0,1,0,1,0,0,1
iD0FyyZNzNw,13,49,1,63,0.20634920634920634,0.20634920634920634,0.7777777777777778
iGGYY1YZtv8,9,18,2,29,0.3103448275862069,0.3103448275862069,0.6206896551724138
iHqMtTXLnk0,41,46,3,90,0.45555555555555555,0.45555555555555555,0.5111111111111111
iIqYnRZWVEI,12,8,0,20,0.6,0.6,0.4
iJH-XqIj0qQ,9,11,4,24,0.375,0.375,0.4583333333333333
iJK748-Hp_w,10,86,2,98,0.10204081632653061,0.10204081632653061,0.8775510204081632
iJa1RQaSVic,10,9,0,19,0.5263157894736842,0.5263157894736842,0.47368421052631576
iJnpldjqd70,4,7,2,13,0.3076923076923077,0.3076923076923077,0.5384615384615384
iKpN89KQKuA,26,22,1,49,0.5306122448979592,0.5306122448979592,0.4489795918367347
iLdcxn9ZTJg,8,4,1,13,0.6153846153846154,0.6153846153846154,0.3076923076923077
iMTtRfvCj6g,4,33,4,41,0.0975609756097561,0.0975609756097561,0.8048780487804879
iOFy1-qDL9M,4,16,1,21,0.19047619047619047,0.19047619047619047,0.7619047619047619
iOgHvdl_FRg,29,89,5,123,0.23577235772357724,0.23577235772357724,0.7235772357723578
iP37t6s6p7Q,5,6,0,11,0.45454545454545453,0.45454545454545453,0.5454545454545454
iPg5A8mHEL4,9,24,1,34,0.2647058823529412,0.2647058823529412,0.7058823529411765
iQmIzwC42TI,2,4,1,7,0.2857142857142857,0.2857142857142857,0.5714285714285714
iQvGclkg7zA,4,9,2,15,0.26666666666666666,0.26666666666666666,0.6
iR_fDrXwW3s,3,4,0,7,0.42857142857142855,0.42857142857142855,0.5714285714285714
iRvmknvMd1A,22,89,3,114,0.19298245614035087,0.19298245614035087,0.7807017543859649
iSAC4oX2VVU,71,45,12,128,0.5546875,0.5546875,0.3515625
iSFhqYc_6-0,61,52,1,114,0.5350877192982456,0.5350877192982456,0.45614035087719296
iVCDp9jM4Oo,2,3,0,5,0.4,0.4,0.6
iVmMcV6liXY,5,9,1,15,0.3333333333333333,0.3333333333333333,0.6
iVvW5J3trT0,3,23,1,27,0.1111111111111111,0.1111111111111111,0.8518518518518519
iWEfWMPZhpg,7,7,0,14,0.5,0.5,0.5
iXerqW6a7KE,133,143,27,303,0.4389438943894389,0.4389438943894389,0.47194719471947194
iYb6A_F0qS4,6,16,4,26,0.23076923076923078,0.23076923076923078,0.6153846153846154
iYqhEL_kjLA,8,36,0,44,0.18181818181818182,0.18181818181818182,0.8181818181818182
iZzP4z2TBcE,47,84,11,142,0.33098591549295775,0.33098591549295775,0.5915492957746479
i_4v2aC0aiY,5,29,2,36,0.1388888888888889,0.1388888888888889,0.8055555555555556
i_CrCfI1rNA,13,23,4,40,0.325,0.325,0.575
i_TDzQBkyqc,16,23,1,40,0.4,0.4,0.575
i_f3V8ipbqs,97,111,14,222,0.4369369369369369,0.4369369369369369,0.5
iaynZ1Xo81M,6,23,5,34,0.17647058823529413,0.17647058823529413,0.6764705882352942
ibNNbGa3euo,19,24,1,44,0.4318181818181818,0.4318181818181818,0.5454545454545454
iblCkAQe7hw,1,6,1,8,0.125,0.125,0.75
id-owaxD_uE,4,3,0,7,0.5714285714285714,0.5714285714285714,0.42857142857142855
ie5XiidkZwU,24,29,4,57,0.42105263157894735,0.42105263157894735,0.5087719298245614
ieJOD4jlF9M,17,65,12,94,0.18085106382978725,0.18085106382978725,0.6914893617021277
ieX9ttxhflU,29,58,4,91,0.31868131868131866,0.31868131868131866,0.6373626373626373
iejyiTtnfQM,0,1,1,2,0,0,0.5
igf1zxAUMWY,14,182,14,210,0.06666666666666667,0.06666666666666667,0.8666666666666667
ii5KE0FfBXM,182,412,48,642,0.2834890965732087,0.2834890965732087,0.6417445482866043
iirJmwnq3PA,2,8,0,10,0.2,0.2,0.8
iivAVg9_1mA,13,26,2,41,0.3170731707317073,0.3170731707317073,0.6341463414634146
ijZKi8WzsGo,26,18,4,48,0.5416666666666666,0.5416666666666666,0.375
ik42kSBXwbE,2,22,2,26,0.07692307692307693,0.07692307692307693,0.8461538461538461
ikoizA4uI4k,19,9,1,29,0.6551724137931034,0.6551724137931034,0.3103448275862069
il1dGIpCmwY,3,13,0,16,0.1875,0.1875,0.8125
ilJfsAKlhfs,6,28,6,40,0.15,0.15,0.7
ilRU2OTqt-U,6,19,3,28,0.21428571428571427,0.21428571428571427,0.6785714285714286
ilZgcE0fFMA,9,4,2,15,0.6,0.6,0.26666666666666666
ipSk3XkykHg,208,103,24,335,0.6208955223880597,0.6208955223880597,0.3074626865671642
ipoooUE7ifI,9,12,3,24,0.375,0.375,0.5
ipsrjbBl-k4,157,353,18,528,0.29734848484848486,0.29734848484848486,0.6685606060606061
irkHvMGj1HE,8,11,0,19,0.42105263157894735,0.42105263157894735,0.5789473684210527
irlCa0WWRFk,51,90,2,143,0.35664335664335667,0.35664335664335667,0.6293706293706294
irxq3fB-kSw,4,33,1,38,0.10526315789473684,0.10526315789473684,0.868421052631579
is4HNeYcwhE,3,10,0,13,0.23076923076923078,0.23076923076923078,0.7692307692307693
is8j90WLacE,223,91,12,326,0.6840490797546013,0.6840490797546013,0.2791411042944785
iujMwbPm174,8,3,2,13,0.6153846153846154,0.6153846153846154,0.23076923076923078
ivKddCsmAlc,2,16,0,18,0.1111111111111111,0.1111111111111111,0.8888888888888888
iyGj5PRDung,9,9,2,20,0.45,0.45,0.45
iyo7bCyV78I,4,8,0,12,0.3333333333333333,0.3333333333333333,0.6666666666666666
izkm53i3sU0,7,29,6,42,0.16666666666666666,0.16666666666666666,0.6904761904761905
j04BA0Gznsg,15,10,1,26,0.5769230769230769,0.5769230769230769,0.38461538461538464
j0Ol1Cs_TWA,5,12,0,17,0.29411764705882354,0.29411764705882354,0.7058823529411765
j0e3zuOccFQ,3,17,2,22,0.13636363636363635,0.13636363636363635,0.7727272727272727
j0sY0SUNMjI,5,2,1,8,0.625,0.625,0.25
j2jgBsJNFaQ,41,25,11,77,0.5324675324675324,0.5324675324675324,0.3246753246753247
j4BopHorBzA,11,37,2,50,0.22,0.22,0.74
j7EKfwDVW5s,12,18,1,31,0.3870967741935484,0.3870967741935484,0.5806451612903226
j7Zhnyivn7s,5,1,0,6,0.8333333333333334,0.8333333333333334,0.16666666666666666
j7bJzTej3Nk,16,12,2,30,0.5333333333333333,0.5333333333333333,0.4
j7v5lZxsVrY,17,56,4,77,0.22077922077922077,0.22077922077922077,0.7272727272727273
j9KU2vQgAV0,7,15,3,25,0.28,0.28,0.6
jA0_7dcQgzM,19,13,2,34,0.5588235294117647,0.5588235294117647,0.38235294117647056
jB1ZSuuBeKM,9,9,1,19,0.47368421052631576,0.47368421052631576,0.47368421052631576
jBPIQn0tEgw,23,88,7,118,0.19491525423728814,0.19491525423728814,0.7457627118644068
jC__zFTNgas,59,118,20,197,0.29949238578680204,0.29949238578680204,0.5989847715736041
jESxHd1gHVM,7,4,1,12,0.5833333333333334,0.5833333333333334,0.3333333333333333
jF3Iw_UWwC0,3,12,2,17,0.17647058823529413,0.17647058823529413,0.7058823529411765
jGS__7GrieI,15,16,4,35,0.42857142857142855,0.42857142857142855,0.45714285714285713
jGuVDWm4qY8,12,39,9,60,0.2,0.2,0.65
jHVA-gwk9m4,1,3,0,4,0.25,0.25,0.75
jHo6tq3vN3o,9,23,3,35,0.2571428571428571,0.2571428571428571,0.6571428571428571
jITCH5guH70,188,954,59,1201,0.1565362198168193,0.1565362198168193,0.794338051623647
jJFmEIJMxqw,41,12,2,55,0.7454545454545455,0.7454545454545455,0.21818181818181817
jKGew8RHM7g,9,4,0,13,0.6923076923076923,0.6923076923076923,0.3076923076923077
jKOtkxsfNZo,14,48,2,64,0.21875,0.21875,0.75
jM-5cFoOMSk,24,82,16,122,0.19672131147540983,0.19672131147540983,0.6721311475409836
jMQ1GMh2eR0,9,12,0,21,0.42857142857142855,0.42857142857142855,0.5714285714285714
jNAQS8b9a3Y,35,20,0,55,0.6363636363636364,0.6363636363636364,0.36363636363636365
jO_wH8DSmKo,5,10,1,16,0.3125,0.3125,0.625
jQywTM4izzg,39,10,2,51,0.7647058823529411,0.7647058823529411,0.19607843137254902
jRP-jVTJOo0,5,15,5,25,0.2,0.2,0.6
jTAR9VLY0jo,21,56,10,87,0.2413793103448276,0.2413793103448276,0.6436781609195402
jTxLUwAvKJ0,21,30,1,52,0.40384615384615385,0.40384615384615385,0.5769230769230769
jU7NamVniFU,9,35,2,46,0.1956521739130435,0.1956521739130435,0.7608695652173914
jUB-B6p8WKQ,8,0,0,8,1,1,0
jUB2cWRfDK0,23,51,5,79,0.2911392405063291,0.2911392405063291,0.6455696202531646
jVhtY4divZg,17,30,4,51,0.3333333333333333,0.3333333333333333,0.5882352941176471
jYm31m6GCJw,14,6,1,21,0.6666666666666666,0.6666666666666666,0.2857142857142857
j_5UwM7eLL8,44,114,15,173,0.2543352601156069,0.2543352601156069,0.6589595375722543
jaoBZyzu9EI,123,237,20,380,0.3236842105263158,0.3236842105263158,0.6236842105263158
jbDS-hw-bO4,11,15,5,31,0.3548387096774194,0.3548387096774194,0.4838709677419355
jbPwhlm_lfA,3,9,0,12,0.25,0.25,0.75
jbcZXgoEcsM,11,39,11,61,0.18032786885245902,0.18032786885245902,0.639344262295082
jcnwH6Eqd2U,10,19,6,35,0.2857142857142857,0.2857142857142857,0.5428571428571428
jdvgbqMlK1k,58,43,12,113,0.5132743362831859,0.5132743362831859,0.3805309734513274
jfkvLScWV5g,9,15,1,25,0.36,0.36,0.6
jjPsYScUyno,15,17,2,34,0.4411764705882353,0.4411764705882353,0.5
jkdLsItxAN4,8,18,4,30,0.26666666666666666,0.26666666666666666,0.6
jl5r6bA_CBY,62,227,9,298,0.2080536912751678,0.2080536912751678,0.761744966442953
jlvFlo9fGO0,2,9,0,11,0.18181818181818182,0.18181818181818182,0.8181818181818182
jmjgMgdAzNs,13,13,2,28,0.4642857142857143,0.4642857142857143,0.4642857142857143
joCvPZPOTtQ,7,7,1,15,0.4666666666666667,0.4666666666666667,0.4666666666666667
jokYGjqxT2s,6,56,3,65,0.09230769230769231,0.09230769230769231,0.8615384615384616
jonyhBy2kKs,39,29,2,70,0.5571428571428572,0.5571428571428572,0.4142857142857143
jsKD6jHvm-g,27,12,2,41,0.6585365853658537,0.6585365853658537,0.2926829268292683
jsnzBWCgX6A,26,32,5,63,0.4126984126984127,0.4126984126984127,0.5079365079365079
jtQD5PCu234,21,38,7,66,0.3181818181818182,0.3181818181818182,0.5757575757575758
jvNswKJQ6Wo,8,13,2,23,0.34782608695652173,0.34782608695652173,0.5652173913043478
jvdHqSA9YSc,14,50,3,67,0.208955223880597,0.208955223880597,0.746268656716418
jwZbVS99rTc,7,4,2,13,0.5384615384615384,0.5384615384615384,0.3076923076923077
jwjtAeBB4ok,10,55,0,65,0.15384615384615385,0.15384615384615385,0.8461538461538461
jy48omay-ZM,199,416,27,642,0.3099688473520249,0.3099688473520249,0.6479750778816199
k-ECyeFdbDM,38,28,4,70,0.5428571428571428,0.5428571428571428,0.4
k0VzCSmGkhI,12,59,3,74,0.16216216216216217,0.16216216216216217,0.7972972972972973
k1RmtD26LEw,11,77,0,88,0.125,0.125,0.875
k213o7fpdCE,4,2,1,7,0.5714285714285714,0.5714285714285714,0.2857142857142857
k2hyyO5ZGrA,7,5,0,12,0.5833333333333334,0.5833333333333334,0.4166666666666667
k5Bhe3MXVNM,22,99,5,126,0.1746031746031746,0.1746031746031746,0.7857142857142857
k7MeLU_z_Tw,20,22,3,45,0.4444444444444444,0.4444444444444444,0.4888888888888889
k8jMamEQVlI,10,8,2,20,0.5,0.5,0.4
k96GzLtaWS4,671,679,154,1504,0.4461436170212766,0.4461436170212766,0.45146276595744683
kAHBP3zjSHk,1,1,1,3,0.3333333333333333,0.3333333333333333,0.3333333333333333
kBxBSoA1uzU,51,86,12,149,0.3422818791946309,0.3422818791946309,0.5771812080536913
kC-1vJJERdk,4,14,1,19,0.21052631578947367,0.21052631578947367,0.7368421052631579
kFLd65SZTfU,4,4,0,8,0.5,0.5,0.5
kFNl17Evu84,190,110,14,314,0.6050955414012739,0.6050955414012739,0.3503184713375796
kGAkTs0yIbY,11,26,3,40,0.275,0.275,0.65
kGFxkz0QPI8,110,106,11,227,0.4845814977973568,0.4845814977973568,0.4669603524229075
kIxNgxyLlWs,31,149,20,200,0.155,0.155,0.745
kKIln5AyS8I,14,76,9,99,0.1414141414141414,0.1414141414141414,0.7676767676767676
kLPOkGwxf-o,10,13,0,23,0.43478260869565216,0.43478260869565216,0.5652173913043478
kMlFvbekLes,5,18,2,25,0.2,0.2,0.72
kO9oBgfW-Bs,21,70,8,99,0.21212121212121213,0.21212121212121213,0.7070707070707071
kPHKr2Fluz8,7,39,3,49,0.14285714285714285,0.14285714285714285,0.7959183673469388
kQDoHYN9L0g,18,22,1,41,0.43902439024390244,0.43902439024390244,0.5365853658536586
kQIbXEbGZ6U,72,41,5,118,0.6101694915254238,0.6101694915254238,0.3474576271186441
kQK_vyjRw6o,33,53,6,92,0.358695652173913,0.358695652173913,0.5760869565217391
kQLLfApzGAc,4,12,1,17,0.23529411764705882,0.23529411764705882,0.7058823529411765
kQtS2sHh0Uc,25,52,7,84,0.2976190476190476,0.2976190476190476,0.6190476190476191
kRWZoHLwHHk,61,42,5,108,0.5648148148148148,0.5648148148148148,0.3888888888888889
kRWhK_ehM2w,5,18,0,23,0.21739130434782608,0.21739130434782608,0.782608695652174
kSAJfcok5Jw,202,31,18,251,0.8047808764940239,0.8047808764940239,0.12350597609561753
kV7XdKoCHCE,6,18,3,27,0.2222222222222222,0.2222222222222222,0.6666666666666666
kVc_KifOaMg,17,25,4,46,0.3695652173913043,0.3695652173913043,0.5434782608695652
kWCJ1axC8Os,632,2305,299,3236,0.19530284301606923,0.19530284301606923,0.7122991347342398
kX45uwwHqRM,3,10,0,13,0.23076923076923078,0.23076923076923078,0.7692307692307693
kXVTT9zqOus,7,11,2,20,0.35,0.35,0.55
kXmcoQ9U5lo,0,1,0,1,0,0,1
kYqKuRr038Y,31,32,5,68,0.45588235294117646,0.45588235294117646,0.47058823529411764
kZ-BbuGnPyc,9,12,1,22,0.4090909090909091,0.4090909090909091,0.5454545454545454
kZSDGGatBME,11,8,2,21,0.5238095238095238,0.5238095238095238,0.38095238095238093
kZvoWAkj_jM,6,12,0,18,0.3333333333333333,0.3333333333333333,0.6666666666666666
k_RDWH_O8iw,1,0,1,2,0.5,0.5,0
kakkFMf3XD0,29,21,6,56,0.5178571428571429,0.5178571428571429,0.375
kcCPqzQ1f1Y,6,7,1,14,0.42857142857142855,0.42857142857142855,0.5
kcZO7DePp8E,11,20,2,33,0.3333333333333333,0.3333333333333333,0.6060606060606061
kdHk5yK2k6c,3,6,1,10,0.3,0.3,0.6
ke7NAAXIAOY,4,16,4,24,0.16666666666666666,0.16666666666666666,0.6666666666666666
kej80AAFu7I,52,76,10,138,0.37681159420289856,0.37681159420289856,0.5507246376811594
kio9BVu_aA0,3,17,1,21,0.14285714285714285,0.14285714285714285,0.8095238095238095
kkrKt3M4gw4,35,34,8,77,0.45454545454545453,0.45454545454545453,0.44155844155844154
kmXLlkMHCEY,13,47,2,62,0.20967741935483872,0.20967741935483872,0.7580645161290323
kmXj75JR3eA,1,4,1,6,0.16666666666666666,0.16666666666666666,0.6666666666666666
kmzl_VORApI,4,9,1,14,0.2857142857142857,0.2857142857142857,0.6428571428571429
kq5OM6S86g0,1,8,1,10,0.1,0.1,0.8
kqOr8w9rkXI,7,32,3,42,0.16666666666666666,0.16666666666666666,0.7619047619047619
kqmISAxJkhA,7,9,0,16,0.4375,0.4375,0.5625
krOjb7m7eEg,1,10,0,11,0.09090909090909091,0.09090909090909091,0.9090909090909091
kryFr5WoAT8,6,16,0,22,0.2727272727272727,0.2727272727272727,0.7272727272727273
ktC8_X_JI7Q,22,46,9,77,0.2857142857142857,0.2857142857142857,0.5974025974025974
kuXZ9olSNwU,8,26,1,35,0.22857142857142856,0.22857142857142856,0.7428571428571429
kudOEHjpxpI,11,54,8,73,0.1506849315068493,0.1506849315068493,0.7397260273972602
kwRRPraeUDw,25,74,10,109,0.22935779816513763,0.22935779816513763,0.6788990825688074
kzBZxWxBZYk,25,101,8,134,0.1865671641791045,0.1865671641791045,0.753731343283582
l08EhzJDh7k,23,47,5,75,0.30666666666666664,0.30666666666666664,0.6266666666666667
l3He5VOJ0Is,9,19,3,31,0.2903225806451613,0.2903225806451613,0.6129032258064516
l4LXbxK5Q_4,288,1055,189,1532,0.18798955613577023,0.18798955613577023,0.6886422976501305
l4jF6V_BleQ,10,28,3,41,0.24390243902439024,0.24390243902439024,0.6829268292682927
l5gTV0eSiYY,36,26,8,70,0.5142857142857142,0.5142857142857142,0.37142857142857144
l6i1l8BSps8,35,21,2,58,0.603448275862069,0.603448275862069,0.3620689655172414
l7RtAiioO7c,34,48,15,97,0.35051546391752575,0.35051546391752575,0.4948453608247423
l8C9o6io5y0,21,46,3,70,0.3,0.3,0.6571428571428571
l8K3q9lO-SQ,36,109,7,152,0.23684210526315788,0.23684210526315788,0.7171052631578947
l8gGV9PT2ho,78,124,8,210,0.37142857142857144,0.37142857142857144,0.5904761904761905
l8jD_FRlP4c,29,76,18,123,0.23577235772357724,0.23577235772357724,0.6178861788617886
l8xlBMp30AY,5,16,1,22,0.22727272727272727,0.22727272727272727,0.7272727272727273
l9GZnXHtbDg,5,23,1,29,0.1724137931034483,0.1724137931034483,0.7931034482758621
l9f79--9z4A,92,544,76,712,0.12921348314606743,0.12921348314606743,0.7640449438202247
lA9wKS12RVk,10,41,12,63,0.15873015873015872,0.15873015873015872,0.6507936507936508
lC9ftU2hZuI,9,17,1,27,0.3333333333333333,0.3333333333333333,0.6296296296296297
lCImTvveZRI,14,40,2,56,0.25,0.25,0.7142857142857143
lDrTxq6-U28,39,95,6,140,0.2785714285714286,0.2785714285714286,0.6785714285714286
lEBWgjZ_r1A,21,175,8,204,0.10294117647058823,0.10294117647058823,0.8578431372549019
lEGCyhyaGQQ,14,12,1,27,0.5185185185185185,0.5185185185185185,0.4444444444444444
lEoLUM1j4no,3,4,0,7,0.42857142857142855,0.42857142857142855,0.5714285714285714
lF8w4feVexQ,32,14,3,49,0.6530612244897959,0.6530612244897959,0.2857142857142857
lGLFzoYJ17o,13,56,10,79,0.16455696202531644,0.16455696202531644,0.7088607594936709
lGz40pSiFOs,25,35,4,64,0.390625,0.390625,0.546875
lHrCM3y5DZU,41,55,16,112,0.36607142857142855,0.36607142857142855,0.49107142857142855
lIjm3SiTqwI,7,21,1,29,0.2413793103448276,0.2413793103448276,0.7241379310344828
lKt8FjZVLUA,10,34,3,47,0.2127659574468085,0.2127659574468085,0.723404255319149
lLdzOT_FQww,46,38,8,92,0.5,0.5,0.41304347826086957
lLzsrDd_dwA,29,107,16,152,0.19078947368421054,0.19078947368421054,0.7039473684210527
lM5dsPjP1OQ,1,1,1,3,0.3333333333333333,0.3333333333333333,0.3333333333333333
lNlnU46OlBA,15,37,4,56,0.26785714285714285,0.26785714285714285,0.6607142857142857
lOCB_mfAfg8,3,7,1,11,0.2727272727272727,0.2727272727272727,0.6363636363636364
lPeFmmm4nBU,14,20,3,37,0.3783783783783784,0.3783783783783784,0.5405405405405406
lPtSp_6tR70,95,67,8,170,0.5588235294117647,0.5588235294117647,0.3941176470588235
lQAeTQ7Afj8,11,17,1,29,0.3793103448275862,0.3793103448275862,0.5862068965517241
lRyaNaVHJcw,20,19,1,40,0.5,0.5,0.475
lSoVbsj_YIE,4,4,2,10,0.4,0.4,0.4
lU-SThpryV4,17,19,1,37,0.4594594594594595,0.4594594594594595,0.5135135135135135
lUO8ZLJhaOQ,54,218,9,281,0.19217081850533807,0.19217081850533807,0.7758007117437722
lUP0_MJ4Xa8,7,5,1,13,0.5384615384615384,0.5384615384615384,0.38461538461538464
lYKk6fXxik8,197,409,52,658,0.2993920972644377,0.2993920972644377,0.621580547112462
lYmuAS7l6SY,3,9,1,13,0.23076923076923078,0.23076923076923078,0.6923076923076923
lZWkVKqgjmE,19,126,14,159,0.11949685534591195,0.11949685534591195,0.7924528301886793
laV8C3RS6TY,5,5,5,15,0.3333333333333333,0.3333333333333333,0.3333333333333333
lcDnV39I7Dc,6,39,3,48,0.125,0.125,0.8125
ledEYT2wO1U,24,133,3,160,0.15,0.15,0.83125
lejHlb7J5uE,6,9,1,16,0.375,0.375,0.5625
lf0PKD-_Jzc,7,11,3,21,0.3333333333333333,0.3333333333333333,0.5238095238095238
lflhnP6N9p0,2,4,0,6,0.3333333333333333,0.3333333333333333,0.6666666666666666
lgYGCLZoa7U,9,5,4,18,0.5,0.5,0.2777777777777778
lh8zvm5_lV8,16,24,2,42,0.38095238095238093,0.38095238095238093,0.5714285714285714
lhuLDzYfzwA,86,359,28,473,0.18181818181818182,0.18181818181818182,0.758985200845666
ljD_PxeKtN4,42,88,19,149,0.28187919463087246,0.28187919463087246,0.5906040268456376
ljeCmmUsNCM,10,41,4,55,0.18181818181818182,0.18181818181818182,0.7454545454545455
ljiRKwdIypo,6,45,3,54,0.1111111111111111,0.1111111111111111,0.8333333333333334
lka8lP-bs3I,46,56,8,110,0.41818181818181815,0.41818181818181815,0.509090909090909
llnv9kPrQrU,42,79,6,127,0.33070866141732286,0.33070866141732286,0.6220472440944882
lmhHvX2LkXw,4,10,0,14,0.2857142857142857,0.2857142857142857,0.7142857142857143
lnn4OFyz4kw,5,17,5,27,0.18518518518518517,0.18518518518518517,0.6296296296296297
lopazDZPW-c,10,5,2,17,0.5882352941176471,0.5882352941176471,0.29411764705882354
lqJLeqxF2JY,8,13,4,25,0.32,0.32,0.52
lqZ_JnzcqM0,3,6,0,9,0.3333333333333333,0.3333333333333333,0.6666666666666666
lqjiu90M6mc,13,19,2,34,0.38235294117647056,0.38235294117647056,0.5588235294117647
lsKcdtSUmjM,22,68,5,95,0.23157894736842105,0.23157894736842105,0.7157894736842105
ltJlYrEdDX4,3,6,1,10,0.3,0.3,0.6
luLbPudqvwk,13,36,0,49,0.2653061224489796,0.2653061224489796,0.7346938775510204
lvFU2k7n08A,7,46,2,55,0.12727272727272726,0.12727272727272726,0.8363636363636363
lwXqS8TKXWo,4,18,5,27,0.14814814814814814,0.14814814814814814,0.6666666666666666
lwx7otZUhHc,194,133,16,343,0.565597667638484,0.565597667638484,0.3877551020408163
lxSqSjxjH_s,12,27,2,41,0.2926829268292683,0.2926829268292683,0.6585365853658537
lz0uTGd-6c4,192,79,9,280,0.6857142857142857,0.6857142857142857,0.28214285714285714
m12cHx6YDyg,13,9,2,24,0.5416666666666666,0.5416666666666666,0.375
m28WYmcH6EU,4,9,0,13,0.3076923076923077,0.3076923076923077,0.6923076923076923
m3gPnn6ylhU,2,6,0,8,0.25,0.25,0.75
m4Ovxw3vFlU,12,6,1,19,0.631578947368421,0.631578947368421,0.3157894736842105
m5hDwCObaCQ,10,72,1,83,0.12048192771084337,0.12048192771084337,0.8674698795180723
m68x5QsiEOs,11,28,2,41,0.2682926829268293,0.2682926829268293,0.6829268292682927
m7H1DfmMSqI,70,101,12,183,0.3825136612021858,0.3825136612021858,0.5519125683060109
m8MJixGmiwE,34,43,7,84,0.40476190476190477,0.40476190476190477,0.5119047619047619
m8rJRg99Ap8,5,17,1,23,0.21739130434782608,0.21739130434782608,0.7391304347826086
mBxgFasZwew,5,14,0,19,0.2631578947368421,0.2631578947368421,0.7368421052631579
mCiL2rBZ1Eo,9,32,0,41,0.21951219512195122,0.21951219512195122,0.7804878048780488
mCxa5Rl9Imc,57,52,4,113,0.504424778761062,0.504424778761062,0.46017699115044247
mE-j5qVQIS4,7,11,1,19,0.3684210526315789,0.3684210526315789,0.5789473684210527
mEgsH5SB44M,11,32,2,45,0.24444444444444444,0.24444444444444444,0.7111111111111111
mEyh37P83uI,47,19,3,69,0.6811594202898551,0.6811594202898551,0.2753623188405797
mG9SfUSWn9Y,47,31,2,80,0.5875,0.5875,0.3875
mH5hM4p4rGc,112,528,69,709,0.15796897038081806,0.15796897038081806,0.7447108603667136
mJ5Okwzpx7o,13,13,1,27,0.48148148148148145,0.48148148148148145,0.48148148148148145
mKJYcrcveCg,56,89,10,155,0.36129032258064514,0.36129032258064514,0.5741935483870968
mLoMrJrTWXc,10,15,1,26,0.38461538461538464,0.38461538461538464,0.5769230769230769
mMC3weDUhDo,3,3,1,7,0.42857142857142855,0.42857142857142855,0.42857142857142855
mOMEA0UhA0s,2,10,3,15,0.13333333333333333,0.13333333333333333,0.6666666666666666
mPa2qnwH67k,6,16,1,23,0.2608695652173913,0.2608695652173913,0.6956521739130435
mPd3le0yoxU,16,69,3,88,0.18181818181818182,0.18181818181818182,0.7840909090909091
mRgWFCRZvTU,11,19,2,32,0.34375,0.34375,0.59375
mSC_Bo5-Fgs,6,16,2,24,0.25,0.25,0.6666666666666666
mUbZMZB1DmQ,14,12,2,28,0.5,0.5,0.42857142857142855
mVUfZbxfnoc,10,27,2,39,0.2564102564102564,0.2564102564102564,0.6923076923076923
mXjlkGkEbTc,4,9,2,15,0.26666666666666666,0.26666666666666666,0.6
mXltSix8z24,4,3,0,7,0.5714285714285714,0.5714285714285714,0.42857142857142855
mXpU7dvDH20,1,6,3,10,0.1,0.1,0.6
mXx0qfPs-Ps,2,8,0,10,0.2,0.2,0.8
mZ7CbNtHIAI,17,28,11,56,0.30357142857142855,0.30357142857142855,0.5
m_5WxQrmDBw,8,13,0,21,0.38095238095238093,0.38095238095238093,0.6190476190476191
m_qRn9XroWE,30,21,2,53,0.5660377358490566,0.5660377358490566,0.39622641509433965
mblrM0fNvQc,2,1,4,7,0.2857142857142857,0.2857142857142857,0.14285714285714285
mcEKQO7M34g,0,11,0,11,0,0,1
mdG0sjCt_PM,17,9,3,29,0.5862068965517241,0.5862068965517241,0.3103448275862069
mfSfRsMMd_4,4,18,4,26,0.15384615384615385,0.15384615384615385,0.6923076923076923
mfmeKKhjDdI,25,106,7,138,0.18115942028985507,0.18115942028985507,0.7681159420289855
mfxNoXU5YBk,24,30,1,55,0.43636363636363634,0.43636363636363634,0.5454545454545454
mg6Qspaewfo,5,3,1,9,0.5555555555555556,0.5555555555555556,0.3333333333333333
mgGaNfYOxiI,284,188,63,535,0.5308411214953271,0.5308411214953271,0.3514018691588785
mgQJjTMs950,1,0,0,1,1,1,0
mhIDIC6eZBI,548,92,21,661,0.8290468986384266,0.8290468986384266,0.13918305597579425
mhXuvTN20c4,6,19,4,29,0.20689655172413793,0.20689655172413793,0.6551724137931034
mhuhIRpbv0E,16,33,5,54,0.2962962962962963,0.2962962962962963,0.6111111111111112
mig53jmOs5M,11,34,4,49,0.22448979591836735,0.22448979591836735,0.6938775510204082
mkgFteLBFy8,5,5,0,10,0.5,0.5,0.5
mlNEKRYseDI,3,15,2,20,0.15,0.15,0.75
mloOF6bjsoY,1,2,0,3,0.3333333333333333,0.3333333333333333,0.6666666666666666
mnwrk7SoZI8,10,48,8,66,0.15151515151515152,0.15151515151515152,0.7272727272727273
moMMqNHDYO4,6,8,2,16,0.375,0.375,0.5
mpQWom0Mipo,2,41,5,48,0.041666666666666664,0.041666666666666664,0.8541666666666666
mptSK3Hc5fU,57,42,16,115,0.4956521739130435,0.4956521739130435,0.3652173913043478
mqEZm95u59o,2,18,1,21,0.09523809523809523,0.09523809523809523,0.8571428571428571
mtXQox8BuOY,38,90,5,133,0.2857142857142857,0.2857142857142857,0.6766917293233082
mwHLETCXhR8,10,20,0,30,0.3333333333333333,0.3333333333333333,0.6666666666666666
mw_K7dHzY1Q,3,1,0,4,0.75,0.75,0.25
mwdEZdNmtJY,23,35,3,61,0.3770491803278688,0.3770491803278688,0.5737704918032787
mx40d8rSi80,8,11,1,20,0.4,0.4,0.55
myMC0zFQGjE,11,8,1,20,0.55,0.55,0.4
myr6QnUSmro,83,79,10,172,0.48255813953488375,0.48255813953488375,0.45930232558139533
mzmQyMnxCVA,32,27,0,59,0.5423728813559322,0.5423728813559322,0.4576271186440678
n0F5OyiBzIs,18,15,3,36,0.5,0.5,0.4166666666666667
n1CEM01Hxg0,7,37,5,49,0.14285714285714285,0.14285714285714285,0.7551020408163265
n343Y0XdZGY,4,4,0,8,0.5,0.5,0.5
n39DhCkdECo,33,42,7,82,0.4024390243902439,0.4024390243902439,0.5121951219512195
n48hH0q6paE,37,27,4,68,0.5441176470588235,0.5441176470588235,0.39705882352941174
n4WSeaG3lmo,15,21,1,37,0.40540540540540543,0.40540540540540543,0.5675675675675675
n4xPHdCv6yk,27,22,6,55,0.4909090909090909,0.4909090909090909,0.4
n4zHTOVL66I,12,8,0,20,0.6,0.6,0.4
n55KCIz5Hf8,5,61,4,70,0.07142857142857142,0.07142857142857142,0.8714285714285714
n5OfgGoR8hQ,31,40,2,73,0.4246575342465753,0.4246575342465753,0.547945205479452
n6tEfBYfClc,2,15,1,18,0.1111111111111111,0.1111111111111111,0.8333333333333334
n7w7PENaFxw,34,46,5,85,0.4,0.4,0.5411764705882353
n8tOm6gtnMw,8,24,3,35,0.22857142857142856,0.22857142857142856,0.6857142857142857
nAJL7QAoDaU,8,31,1,40,0.2,0.2,0.775
nAW9L5rRjCo,54,137,25,216,0.25,0.25,0.6342592592592593
nBAR4PmJRZM,6,21,1,28,0.21428571428571427,0.21428571428571427,0.75
nCfTJ-sQEDo,16,34,3,53,0.3018867924528302,0.3018867924528302,0.6415094339622641
nD-BC9Nn-hA,6,8,1,15,0.4,0.4,0.5333333333333333
nEkdXX51u9Q,13,12,2,27,0.48148148148148145,0.48148148148148145,0.4444444444444444
nF41h9FWMoA,28,45,6,79,0.35443037974683544,0.35443037974683544,0.569620253164557
nFqjX1MaLSI,31,32,7,70,0.44285714285714284,0.44285714285714284,0.45714285714285713
nFqz0vBAc0Y,31,23,4,58,0.5344827586206896,0.5344827586206896,0.39655172413793105
nH6_xX2oav0,10,7,0,17,0.5882352941176471,0.5882352941176471,0.4117647058823529
nIzaJTphdTY,4,24,0,28,0.14285714285714285,0.14285714285714285,0.8571428571428571
nKKGQCAApaU,6,12,0,18,0.3333333333333333,0.3333333333333333,0.6666666666666666
nKX6rlWJvXI,52,127,13,192,0.2708333333333333,0.2708333333333333,0.6614583333333334
nL1mCmPBpGk,13,20,3,36,0.3611111111111111,0.3611111111111111,0.5555555555555556
nLoaEigyphc,7,42,8,57,0.12280701754385964,0.12280701754385964,0.7368421052631579
nOi6zr9IXtc,3,14,2,19,0.15789473684210525,0.15789473684210525,0.7368421052631579
nPcYv0aL_rE,6,3,3,12,0.5,0.5,0.25
nPttr44_VHU,48,156,14,218,0.22018348623853212,0.22018348623853212,0.7155963302752294
nS0_rm8qxMQ,17,15,0,32,0.53125,0.53125,0.46875
nS4nivyeEmY,3,14,2,19,0.15789473684210525,0.15789473684210525,0.7368421052631579
nSh8jLNEHCY,40,76,5,121,0.3305785123966942,0.3305785123966942,0.628099173553719
nSjolfDrb68,59,30,16,105,0.5619047619047619,0.5619047619047619,0.2857142857142857
nSkhxmEDc_4,0,10,0,10,0,0,1
nVcQeIq8n2c,10,7,0,17,0.5882352941176471,0.5882352941176471,0.4117647058823529
nVuCsgzPWL4,23,88,16,127,0.18110236220472442,0.18110236220472442,0.6929133858267716
nW9kuTr3qmo,26,16,3,45,0.5777777777777777,0.5777777777777777,0.35555555555555557
nWs6Y_DJXjs,4,18,2,24,0.16666666666666666,0.16666666666666666,0.75
nXKr2LUQEy8,2,17,2,21,0.09523809523809523,0.09523809523809523,0.8095238095238095
nY5F-GE3eKI,18,24,4,46,0.391304347826087,0.391304347826087,0.5217391304347826
nYltXEBf7YE,9,36,3,48,0.1875,0.1875,0.75
nZKNbWAyAOA,7,10,1,18,0.3888888888888889,0.3888888888888889,0.5555555555555556
n_j5eiXejvk,3,12,1,16,0.1875,0.1875,0.75
naSl7hhk3i0,4,1,1,6,0.6666666666666666,0.6666666666666666,0.16666666666666666
namIuUIBL7U,98,81,8,187,0.5240641711229946,0.5240641711229946,0.43315508021390375
nb4rBflx-jI,8,8,1,17,0.47058823529411764,0.47058823529411764,0.47058823529411764
nbW5X4Obq00,8,8,6,22,0.36363636363636365,0.36363636363636365,0.36363636363636365
ncArBU8pKbo,13,29,3,45,0.28888888888888886,0.28888888888888886,0.6444444444444445
ncfKa8h0NrA,18,49,2,69,0.2608695652173913,0.2608695652173913,0.7101449275362319
ne1jzI1bRVE,12,17,2,31,0.3870967741935484,0.3870967741935484,0.5483870967741935
neNLGCJVjdQ,2,2,1,5,0.4,0.4,0.4
neWXrLj01RQ,6,13,1,20,0.3,0.3,0.65
nekWDuO40U0,24,41,3,68,0.35294117647058826,0.35294117647058826,0.6029411764705882
nfsomup52d8,6,3,3,12,0.5,0.5,0.25
ngevPicmrRM,8,9,0,17,0.47058823529411764,0.47058823529411764,0.5294117647058824
ngmdn968WM0,0,7,1,8,0,0,0.875
nhzYurcQTkQ,5,21,4,30,0.16666666666666666,0.16666666666666666,0.7
nkLBCfrgZkU,48,33,4,85,0.5647058823529412,0.5647058823529412,0.38823529411764707
nkmkzKM2URY,15,44,5,64,0.234375,0.234375,0.6875
nliW0Q0py7Y,7,29,5,41,0.17073170731707318,0.17073170731707318,0.7073170731707317
nm8gJIwnfIY,10,52,2,64,0.15625,0.15625,0.8125
nmfArbJHcuQ,6,7,0,13,0.46153846153846156,0.46153846153846156,0.5384615384615384
nmkbq6WOOHc,19,44,4,67,0.2835820895522388,0.2835820895522388,0.6567164179104478
nnxAooOXEIY,4,1,1,6,0.6666666666666666,0.6666666666666666,0.16666666666666666
npU4e7v4E38,11,17,3,31,0.3548387096774194,0.3548387096774194,0.5483870967741935
nqm4-8g3l_w,9,3,2,14,0.6428571428571429,0.6428571428571429,0.21428571428571427
nraQXrlJZ-w,19,20,3,42,0.4523809523809524,0.4523809523809524,0.47619047619047616
nrh_yLCO4BE,2,11,0,13,0.15384615384615385,0.15384615384615385,0.8461538461538461
nsi87SXwLe4,97,37,8,142,0.6830985915492958,0.6830985915492958,0.2605633802816901
nvN_7Sfpso4,53,23,1,77,0.6883116883116883,0.6883116883116883,0.2987012987012987
nvYym6TGT3Q,4,7,0,11,0.36363636363636365,0.36363636363636365,0.6363636363636364
nwhLAevQY5o,8,29,1,38,0.21052631578947367,0.21052631578947367,0.7631578947368421
nyEi1sX6V1w,6,73,7,86,0.06976744186046512,0.06976744186046512,0.8488372093023255
nyM2HwG49Ug,20,49,5,74,0.2702702702702703,0.2702702702702703,0.6621621621621622
nyVWeM3BoZo,3,22,1,26,0.11538461538461539,0.11538461538461539,0.8461538461538461
nzJFuVaTx9k,7,23,3,33,0.21212121212121213,0.21212121212121213,0.696969696969697
nzb1rwN51uo,59,190,16,265,0.22264150943396227,0.22264150943396227,0.71698113207547165
o-03ipkAIzE,12,17,1,30,0.4,0.4,0.5666666666666667
o-nvQOBD7_E,994,1622,435,3051,0.3257948213700426,0.3257948213700426,0.5316289741068502
o0ZJZxAxvEs,2,17,1,20,0.1,0.1,0.85
o1-3a5LCaks,16,30,4,50,0.32,0.32,0.6
o1Xxi0ULxfo,6,4,1,11,0.5454545454545454,0.5454545454545454,0.36363636363636365
o20tB75I4E8,3,10,1,14,0.21428571428571427,0.21428571428571427,0.7142857142857143
o3EZNa2wBZ4,0,1,0,1,0,0,1
o735mWQ_8-w,7,5,0,12,0.5833333333333334,0.5833333333333334,0.4166666666666667
o76TnLKrfeM,22,42,4,68,0.3235294117647059,0.3235294117647059,0.6176470588235294
o7nJfWxoE9Y,7,49,3,59,0.11864406779661017,0.11864406779661017,0.8305084745762712
o7ns_ebqebY,10,29,5,44,0.22727272727272727,0.22727272727272727,0.6590909090909091
o8NqcujEzmA,6,9,1,16,0.375,0.375,0.5625
oB9LxxHsw2s,141,123,13,277,0.5090252707581228,0.5090252707581228,0.44404332129963897
oB9cyAXr38o,22,44,7,73,0.3013698630136986,0.3013698630136986,0.6027397260273972
oBfCdipmPTw,5,35,2,42,0.11904761904761904,0.11904761904761904,0.8333333333333334
oBhQzx-qCnU,9,25,2,36,0.25,0.25,0.6944444444444444
oC3zlxFrtc8,6,4,1,11,0.5454545454545454,0.5454545454545454,0.36363636363636365
oDmljk5UAIk,77,47,5,129,0.5968992248062015,0.5968992248062015,0.3643410852713178
oDnYnY5wwEU,14,51,1,66,0.21212121212121213,0.21212121212121213,0.7727272727272727
oDrit4EdIwg,29,222,14,265,0.10943396226415095,0.10943396226415095,0.8377358490566038
oE5wc9jZtVo,13,50,4,67,0.19402985074626866,0.19402985074626866,0.746268656716418
oEoX3rTAUko,16,24,3,43,0.37209302325581395,0.37209302325581395,0.5581395348837209
oF1LDqVIS68,10,25,7,42,0.23809523809523808,0.23809523809523808,0.5952380952380952
oHEYBxqGTYE,8,14,4,26,0.3076923076923077,0.3076923076923077,0.5384615384615384
oHUr2x9wg6I,19,23,1,43,0.4418604651162791,0.4418604651162791,0.5348837209302325
oJ8pzqTnt-k,0,2,0,2,0,0,1
oJJpXIYAEuA,23,25,3,51,0.45098039215686275,0.45098039215686275,0.49019607843137253
oL4V5ayaxmg,16,20,2,38,0.42105263157894735,0.42105263157894735,0.5263157894736842
oLZ8s7QsW88,28,139,11,178,0.15730337078651685,0.15730337078651685,0.7808988764044944
oLZYYb5NFG8,19,61,4,84,0.2261904761904762,0.2261904761904762,0.7261904761904762
oLp9jrmhkdA,63,141,24,228,0.27631578947368424,0.27631578947368424,0.618421052631579
oMqb2UqEwKU,3,20,2,25,0.12,0.12,0.8
oO6huiH6J1w,21,13,4,38,0.5526315789473685,0.5526315789473685,0.34210526315789475
oOBQvViZrRA,8,29,2,39,0.20512820512820512,0.20512820512820512,0.7435897435897436
oQ6BTN9xUuw,19,63,15,97,0.1958762886597938,0.1958762886597938,0.6494845360824743
oRoCT8wSHeQ,4,24,2,30,0.13333333333333333,0.13333333333333333,0.8
oRtS8_UXn9c,5,15,2,22,0.22727272727272727,0.22727272727272727,0.6818181818181818
oSV_L6PLIbc,0,1,0,1,0,0,1
oTRxwPJZn_E,7,5,4,16,0.4375,0.4375,0.3125
oU1trNd8H9A,8,17,1,26,0.3076923076923077,0.3076923076923077,0.6538461538461539
oVXeAybs1yw,23,11,0,34,0.6764705882352942,0.6764705882352942,0.3235294117647059
oWPBwuWL614,116,215,43,374,0.31016042780748665,0.31016042780748665,0.5748663101604278
oYMi4Q0S02k,8,5,1,14,0.5714285714285714,0.5714285714285714,0.35714285714285715
o_D9YcemFr4,2,2,0,4,0.5,0.5,0.5
oajBZ3ZLc3Q,9,18,3,30,0.3,0.3,0.6
od3ZOGWF4g4,9,5,0,14,0.6428571428571429,0.6428571428571429,0.35714285714285715
odGolUbV7O4,13,13,2,28,0.4642857142857143,0.4642857142857143,0.4642857142857143
oeKl_5d3ySE,23,22,6,51,0.45098039215686275,0.45098039215686275,0.43137254901960786
oeQFfLAYKLo,84,72,8,164,0.5121951219512195,0.5121951219512195,0.43902439024390244
oeQmjhu1g8s,12,7,1,20,0.6,0.6,0.35
oei6Wn9G-PQ,22,13,2,37,0.5945945945945946,0.5945945945945946,0.35135135135135137
of14wf7I_u0,15,46,4,65,0.23076923076923078,0.23076923076923078,0.7076923076923077
ofie960rDKY,278,116,16,410,0.6780487804878049,0.6780487804878049,0.28292682926829266
ogvvFilLkbk,42,90,14,146,0.2876712328767123,0.2876712328767123,0.6164383561643836
ohFTrLfpdeg,21,41,4,66,0.3181818181818182,0.3181818181818182,0.6212121212121212
ohu6mEmLbs8,9,31,5,45,0.2,0.2,0.6888888888888889
oknbvGo712Y,27,43,4,74,0.36486486486486486,0.36486486486486486,0.581081081081081
omDCqnKfres,20,13,1,34,0.5882352941176471,0.5882352941176471,0.38235294117647056
ondhxJeg3vQ,9,4,2,15,0.6,0.6,0.26666666666666666
opfuK5SqgOg,10,16,1,27,0.37037037037037035,0.37037037037037035,0.5925925925925926
opiYUzuIdno,8,6,1,15,0.5333333333333333,0.5333333333333333,0.4
oq_9eEpyNJw,6,28,2,36,0.16666666666666666,0.16666666666666666,0.7777777777777778
or-RyifwQEE,2,9,1,12,0.16666666666666666,0.16666666666666666,0.75
orcLqAtpqYI,30,31,7,68,0.4411764705882353,0.4411764705882353,0.45588235294117646
ovNa3b4oxTg,6,29,4,39,0.15384615384615385,0.15384615384615385,0.7435897435897436
ow7IXFRvzFE,7,30,7,44,0.1590909090909091,0.1590909090909091,0.6818181818181818
ox-CY3qa0Is,12,29,1,42,0.2857142857142857,0.2857142857142857,0.6904761904761905
oxXQmcHv8SQ,7,5,0,12,0.5833333333333334,0.5833333333333334,0.4166666666666667
oxzXSA1WJIU,32,36,6,74,0.43243243243243246,0.43243243243243246,0.4864864864864865
oxzaRCqKKSg,51,422,35,508,0.10039370078740158,0.10039370078740158,0.8307086614173228
oy5pobzm-N4,4,3,2,9,0.4444444444444444,0.4444444444444444,0.3333333333333333
p00cCQvMAus,14,61,4,79,0.17721518987341772,0.17721518987341772,0.7721518987341772
p0IMdsAOv4c,16,45,5,66,0.24242424242424243,0.24242424242424243,0.6818181818181818
p0KNbYqlGlY,27,65,2,94,0.2872340425531915,0.2872340425531915,0.6914893617021277
p1WoP4xY2sw,16,38,5,59,0.2711864406779661,0.2711864406779661,0.6440677966101694
p35TR2Qiq2U,7,19,3,29,0.2413793103448276,0.2413793103448276,0.6551724137931034
p3CpWI0OGsE,2,9,3,14,0.14285714285714285,0.14285714285714285,0.6428571428571429
p85VuRLxcpA,12,40,2,54,0.2222222222222222,0.2222222222222222,0.7407407407407407
p8SGa4oFFvQ,26,110,5,141,0.18439716312056736,0.18439716312056736,0.7801418439716312
p8aFU6DmMUM,3,11,0,14,0.21428571428571427,0.21428571428571427,0.7857142857142857
p9yioWy6MsE,7,8,0,15,0.4666666666666667,0.4666666666666667,0.5333333333333333
pA7t9oiGn7w,10,12,0,22,0.45454545454545453,0.45454545454545453,0.5454545454545454
pBSpcoHCrLE,32,89,7,128,0.25,0.25,0.6953125
pCZCQq7Ml7I,6,21,4,31,0.1935483870967742,0.1935483870967742,0.6774193548387096
pCwYxC_72g0,16,24,0,40,0.4,0.4,0.6
pDFgvuDgy1Y,7,0,1,8,0.875,0.875,0
pDVs8-hOXLY,10,106,2,118,0.0847457627118644,0.0847457627118644,0.8983050847457628
pDxhfNVxOOg,16,89,9,114,0.14035087719298245,0.14035087719298245,0.7807017543859649
pE2DzBRLqaQ,5,26,1,32,0.15625,0.15625,0.8125
pF86qJGLrWM,7,42,2,51,0.13725490196078433,0.13725490196078433,0.8235294117647058
pFOyTW-Zcws,20,66,3,89,0.2247191011235955,0.2247191011235955,0.7415730337078652
pG92_nGX5zQ,4,4,1,9,0.4444444444444444,0.4444444444444444,0.4444444444444444
pI5YrX30o_A,43,60,17,120,0.35833333333333334,0.35833333333333334,0.5
pI95zVemXfs,6,5,0,11,0.5454545454545454,0.5454545454545454,0.45454545454545453
pIBfrllnhJg,228,555,31,814,0.2800982800982801,0.2800982800982801,0.6818181818181818
pJbeRYOWL7c,7,14,1,22,0.3181818181818182,0.3181818181818182,0.6363636363636364
pJwfWYWSF6c,7,7,2,16,0.4375,0.4375,0.4375
pKhBf4icB30,4,17,1,22,0.18181818181818182,0.18181818181818182,0.7727272727272727
pLXQecX6UME,17,28,4,49,0.3469387755102041,0.3469387755102041,0.5714285714285714
pM4mZg9NnaI,29,133,12,174,0.16666666666666666,0.16666666666666666,0.764367816091954
pMU1EKy3vM8,18,20,5,43,0.4186046511627907,0.4186046511627907,0.46511627906976744
pO37x7KOGig,10,11,4,25,0.4,0.4,0.44
pOkyh2wfp0I,38,331,31,400,0.095,0.095,0.8275
pOx9iK9uP7s,24,19,2,45,0.5333333333333333,0.5333333333333333,0.4222222222222222
pP1astaOKos,8,20,4,32,0.25,0.25,0.625
pPjOV0kzrgE,6,3,0,9,0.6666666666666666,0.6666666666666666,0.3333333333333333
pQarZ5CeWgE,14,41,6,61,0.22950819672131148,0.22950819672131148,0.6721311475409836
pRxQG8inZvc,6,14,2,22,0.2727272727272727,0.2727272727272727,0.6363636363636364
pSNt1HqeSEk,8,33,1,42,0.19047619047619047,0.19047619047619047,0.7857142857142857
pSk67qmRZ3k,115,121,26,262,0.4389312977099237,0.4389312977099237,0.4618320610687023
pTs6yIgklOg,32,127,14,173,0.18497109826589594,0.18497109826589594,0.7341040462427746
pVyE8wq_kP4,14,28,3,45,0.3111111111111111,0.3111111111111111,0.6222222222222222
pWDnaoloN8Y,18,31,2,51,0.35294117647058826,0.35294117647058826,0.6078431372549019
pWxjN7tvydU,0,3,0,3,0,0,1
pXk278lHQN4,6,11,2,19,0.3157894736842105,0.3157894736842105,0.5789473684210527
pYfc48RmTi4,6,27,2,35,0.17142857142857143,0.17142857142857143,0.7714285714285715
pZMpnacg_eo,28,155,15,198,0.1414141414141414,0.1414141414141414,0.7828282828282829
paSoMYs2Xt8,16,7,4,27,0.5925925925925926,0.5925925925925926,0.25925925925925924
pbNkp9DZHLE,18,13,1,32,0.5625,0.5625,0.40625
pbm_sI6Oweo,9,42,1,52,0.17307692307692307,0.17307692307692307,0.8076923076923077
pckN4U6cpuM,34,3,2,39,0.8717948717948718,0.8717948717948718,0.07692307692307693
pfj3CujN3cM,13,46,5,64,0.203125,0.203125,0.71875
phCFP34W8ic,10,23,7,40,0.25,0.25,0.575
pjjV8FGEu2g,3,8,0,11,0.2727272727272727,0.2727272727272727,0.7272727272727273
pk8anIFwh-M,20,11,5,36,0.5555555555555556,0.5555555555555556,0.3055555555555556
pne9Cr5lTk4,9,40,4,53,0.16981132075471697,0.16981132075471697,0.7547169811320755
po-XyedMW5Q,170,158,27,355,0.4788732394366197,0.4788732394366197,0.4450704225352113
pqL_c00sDBY,18,39,2,59,0.3050847457627119,0.3050847457627119,0.6610169491525424
pqSFvW2mcJo,8,18,2,28,0.2857142857142857,0.2857142857142857,0.6428571428571429
prMm7yrp_K4,6,9,1,16,0.375,0.375,0.5625
prcovskf7Uk,3,8,0,11,0.2727272727272727,0.2727272727272727,0.7272727272727273
psbf3YrFGno,43,69,1,113,0.3805309734513274,0.3805309734513274,0.6106194690265486
pu50JZnKZW4,24,83,21,128,0.1875,0.1875,0.6484375
px7QyQH9KO0,15,31,8,54,0.2777777777777778,0.2777777777777778,0.5740740740740741
pxDtKh-r5qU,21,50,4,75,0.28,0.28,0.6666666666666666
pxkObc998Rk,3,13,4,20,0.15,0.15,0.65
pymj3Q4lHtA,7,10,0,17,0.4117647058823529,0.4117647058823529,0.5882352941176471
pzXNdTnx564,19,42,4,65,0.2923076923076923,0.2923076923076923,0.6461538461538462
q0_eH7N1--U,494,1412,431,2337,0.21138211382113822,0.21138211382113822,0.6041934103551562
q4A7cnieOJM,11,21,1,33,0.3333333333333333,0.3333333333333333,0.6363636363636364
q4eq-G-2JTU,13,17,2,32,0.40625,0.40625,0.53125
q4kdK3BbVZw,31,23,4,58,0.5344827586206896,0.5344827586206896,0.39655172413793105
q7HtrwcEXzw,27,36,5,68,0.39705882352941174,0.39705882352941174,0.5294117647058824
q8-l1dW3Q2c,4,2,0,6,0.6666666666666666,0.6666666666666666,0.3333333333333333
q8NkKYEJHxc,8,39,4,51,0.1568627450980392,0.1568627450980392,0.7647058823529411
q8OyL191Z5Q,13,9,3,25,0.52,0.52,0.36
q94Y70Ro9Q8,11,20,3,34,0.3235294117647059,0.3235294117647059,0.5882352941176471
qA3B3ZiZsN0,12,9,1,22,0.5454545454545454,0.5454545454545454,0.4090909090909091
qDUm0XAHV6U,0,3,0,3,0,0,1
qEwJoyPrAqQ,113,35,4,152,0.743421052631579,0.743421052631579,0.23026315789473684
qEzwsWCp6Ho,15,20,0,35,0.42857142857142855,0.42857142857142855,0.5714285714285714
qIQS_ACHSng,21,48,1,70,0.3,0.3,0.6857142857142857
qJB0Vgj9r4I,5,24,2,31,0.16129032258064516,0.16129032258064516,0.7741935483870968
qJv-1JmSYnI,14,16,2,32,0.4375,0.4375,0.5
qKenu6oVlXc,1,6,0,7,0.14285714285714285,0.14285714285714285,0.8571428571428571
qL18HYqQbjQ,1,2,2,5,0.2,0.2,0.4
qLv4IxJZIvY,67,76,11,154,0.43506493506493504,0.43506493506493504,0.4935064935064935
qMtfGxmUYgg,630,180,75,885,0.711864406779661,0.711864406779661,0.2033898305084746
qOO3MZMbfl8,11,29,3,43,0.2558139534883721,0.2558139534883721,0.6744186046511628
qOOtUtI3Wsc,19,24,1,44,0.4318181818181818,0.4318181818181818,0.5454545454545454
qPEgOSw-VqE,9,21,4,34,0.2647058823529412,0.2647058823529412,0.6176470588235294
qPHcvGecILM,25,62,7,94,0.26595744680851063,0.26595744680851063,0.6595744680851063
qRN0tWtwErU,28,53,5,86,0.32558139534883723,0.32558139534883723,0.6162790697674418
qTQ8SUoForI,4,11,2,17,0.23529411764705882,0.23529411764705882,0.6470588235294118
qUEuwDMM4cw,728,243,61,1032,0.7054263565891473,0.7054263565891473,0.23546511627906977
qVKbeXFuyCE,6,14,4,24,0.25,0.25,0.5833333333333334
qVnHbT_RZhg,16,20,5,41,0.3902439024390244,0.3902439024390244,0.4878048780487805
qX9u5gI55aE,14,63,8,85,0.16470588235294117,0.16470588235294117,0.7411764705882353
qXDFubBgUik,23,44,11,78,0.2948717948717949,0.2948717948717949,0.5641025641025641
qXXF2dWAzgc,7,14,1,22,0.3181818181818182,0.3181818181818182,0.6363636363636364
qXsErb1jgkg,11,9,3,23,0.4782608695652174,0.4782608695652174,0.391304347826087
qYU07D-liyQ,10,18,0,28,0.35714285714285715,0.35714285714285715,0.6428571428571429
qYerFg2Ro3c,4,46,4,54,0.07407407407407407,0.07407407407407407,0.8518518518518519
qZEC7ZBQQQ8,7,7,5,19,0.3684210526315789,0.3684210526315789,0.3684210526315789
qZPWYT0Wy-Q,6,21,6,33,0.18181818181818182,0.18181818181818182,0.6363636363636364
qZmp6F7Es0o,9,10,1,20,0.45,0.45,0.5
q_Ur9eTT1Hk,7,15,1,23,0.30434782608695654,0.30434782608695654,0.6521739130434783
qaCiXRdtVEc,0,1,0,1,0,0,1
qaJHmKdJaOE,11,19,2,32,0.34375,0.34375,0.59375
qaLORW09nSA,26,38,12,76,0.34210526315789475,0.34210526315789475,0.5
qbLVIE6phVs,11,38,3,52,0.21153846153846154,0.21153846153846154,0.7307692307692307
qbeRh3f_niA,285,329,52,666,0.42792792792792794,0.42792792792792794,0.493993993993994
qc09UkXzIhY,19,40,3,62,0.3064516129032258,0.3064516129032258,0.6451612903225806
qdcbS8q0jxM,9,22,1,32,0.28125,0.28125,0.6875
qea1cVYA_fQ,43,358,20,421,0.1021377672209026,0.1021377672209026,0.850356294536817
qf-o-FQyZ9Y,8,17,1,26,0.3076923076923077,0.3076923076923077,0.6538461538461539
qfA44cNQNic,43,60,7,110,0.39090909090909093,0.39090909090909093,0.5454545454545454
qfUWLmtRe0U,3,2,1,6,0.5,0.5,0.3333333333333333
qgAK43pOWUM,6,39,4,49,0.12244897959183673,0.12244897959183673,0.7959183673469388
qgqgYsCacuY,20,10,4,34,0.5882352941176471,0.5882352941176471,0.29411764705882354
qgxtI5ttI0o,21,30,6,57,0.3684210526315789,0.3684210526315789,0.5263157894736842
qj4AU-QaHY8,17,7,2,26,0.6538461538461539,0.6538461538461539,0.2692307692307692
qjRBZi6zjFI,23,54,4,81,0.2839506172839506,0.2839506172839506,0.6666666666666666
qk31f3Q9qlM,30,130,18,178,0.16853932584269662,0.16853932584269662,0.7303370786516854
qkmmerSAHuU,119,134,14,267,0.44569288389513106,0.44569288389513106,0.50187265917603
qlC3UC9fnYk,62,146,14,222,0.27927927927927926,0.27927927927927926,0.6576576576576577
qlXCYQrzTw0,17,14,0,31,0.5483870967741935,0.5483870967741935,0.45161290322580644
qlliD4xz8Ug,22,29,7,58,0.3793103448275862,0.3793103448275862,0.5
qlymTLyzpPs,13,21,7,41,0.3170731707317073,0.3170731707317073,0.5121951219512195
qmP4TtPukJs,86,107,6,199,0.4321608040201005,0.4321608040201005,0.5376884422110553
qmz_sZTXc0Y,16,18,1,35,0.45714285714285713,0.45714285714285713,0.5142857142857142
qn1d-J20aQ8,145,89,25,259,0.5598455598455598,0.5598455598455598,0.3436293436293436
qn8JM0Y7Mx0,6,21,2,29,0.20689655172413793,0.20689655172413793,0.7241379310344828
qoGnoHiqQ28,6,9,0,15,0.4,0.4,0.6
qot0UcgthRA,9,33,1,43,0.20930232558139536,0.20930232558139536,0.7674418604651163
qs5KdIgN74g,8,10,1,19,0.42105263157894735,0.42105263157894735,0.5263157894736842
qtlZjbwALfQ,8,31,7,46,0.17391304347826086,0.17391304347826086,0.6739130434782609
qxcbNVKewsg,27,82,3,112,0.24107142857142858,0.24107142857142858,0.7321428571428571
qy0scYERoRo,20,2,1,23,0.8695652173913043,0.8695652173913043,0.08695652173913043
qyCW4DgJPfE,7,5,1,13,0.5384615384615384,0.5384615384615384,0.38461538461538464
qz53MPTtuU0,5,26,3,34,0.14705882352941177,0.14705882352941177,0.7647058823529411
qzlVbm2Pn9c,5,42,1,48,0.10416666666666667,0.10416666666666667,0.875
r-AGLROMtqQ,20,20,3,43,0.46511627906976744,0.46511627906976744,0.46511627906976744
r00faJO2_Z4,18,8,1,27,0.6666666666666666,0.6666666666666666,0.2962962962962963
r02ctpJU-MY,0,6,0,6,0,0,1
r1R2k5sqGz8,32,25,5,62,0.5161290322580645,0.5161290322580645,0.4032258064516129
r3ip8VcnAxE,9,20,2,31,0.2903225806451613,0.2903225806451613,0.6451612903225806
r4Ujxfi5ShY,10,16,3,29,0.3448275862068966,0.3448275862068966,0.5517241379310345
r4YLxpvgOjo,16,55,0,71,0.22535211267605634,0.22535211267605634,0.7746478873239436
r5gRJ1bJZIM,36,35,3,74,0.4864864864864865,0.4864864864864865,0.47297297297297297
r5jNf7wjjuY,93,104,24,221,0.42081447963800905,0.42081447963800905,0.47058823529411764
r5wQAbq4csA,4,21,3,28,0.14285714285714285,0.14285714285714285,0.75
r7cURUi3rH0,13,13,2,28,0.4642857142857143,0.4642857142857143,0.4642857142857143
r9GLSimuZ7o,14,27,1,42,0.3333333333333333,0.3333333333333333,0.6428571428571429
r9oVdIWAzMY,13,12,2,27,0.48148148148148145,0.48148148148148145,0.4444444444444444
rAC-sXVUxoY,17,38,0,55,0.3090909090909091,0.3090909090909091,0.6909090909090909
rAKF3ZumzY8,25,116,13,154,0.16233766233766234,0.16233766233766234,0.7532467532467533
rAYk_JNu_vk,5,25,3,33,0.15151515151515152,0.15151515151515152,0.7575757575757576
rArNvJk9-zE,14,12,3,29,0.4827586206896552,0.4827586206896552,0.41379310344827586
rCPZnfXlAlk,47,117,14,178,0.2640449438202247,0.2640449438202247,0.6573033707865169
rCfYiERge9o,167,722,180,1069,0.15622076707202995,0.15622076707202995,0.6753975678203928
rCv4alnx6kI,7,13,4,24,0.2916666666666667,0.2916666666666667,0.5416666666666666
rDc9b8MHxo0,14,42,8,64,0.21875,0.21875,0.65625
rDr-tu-FVnM,23,34,0,57,0.40350877192982454,0.40350877192982454,0.5964912280701754
rEBuA-vCC_I,89,204,11,304,0.29276315789473684,0.29276315789473684,0.6710526315789473
rEWEUPyefHw,20,99,2,121,0.1652892561983471,0.1652892561983471,0.8181818181818182
rF6mFRqsTcQ,22,66,3,91,0.24175824175824176,0.24175824175824176,0.7252747252747253
rHS8iNsvyYo,18,30,2,50,0.36,0.36,0.6
rHa1Tfn7bCY,9,11,2,22,0.4090909090909091,0.4090909090909091,0.5
rL0KmL0ZnKs,14,3,1,18,0.7777777777777778,0.7777777777777778,0.16666666666666666
rLLNe7t8tyk,17,11,2,30,0.5666666666666667,0.5666666666666667,0.36666666666666664
rMg8AwdYxBE,18,16,3,37,0.4864864864864865,0.4864864864864865,0.43243243243243246
rNpoh-zVgdU,4,13,2,19,0.21052631578947367,0.21052631578947367,0.6842105263157895
rOXaSNNr8d4,9,41,6,56,0.16071428571428573,0.16071428571428573,0.7321428571428571
rOkPkczdJxM,27,137,4,168,0.16071428571428573,0.16071428571428573,0.8154761904761905
rPGoWHA-r-A,2,22,1,25,0.08,0.08,0.88
rRDfMRkbiMA,13,50,3,66,0.19696969696969696,0.19696969696969696,0.7575757575757576
rRRDz5Al5V4,11,23,1,35,0.3142857142857143,0.3142857142857143,0.6571428571428571
rU0AyeOkxdQ,26,18,0,44,0.5909090909090909,0.5909090909090909,0.4090909090909091
rULemjMJI9k,4,22,2,28,0.14285714285714285,0.14285714285714285,0.7857142857142857
rVmQ1XyC1nI,13,17,1,31,0.41935483870967744,0.41935483870967744,0.5483870967741935
rW08pqQBjlg,3,32,1,36,0.08333333333333333,0.08333333333333333,0.8888888888888888
ra8hslbGqPQ,1,11,0,12,0.08333333333333333,0.08333333333333333,0.9166666666666666
rbC9RQX65WM,12,7,4,23,0.5217391304347826,0.5217391304347826,0.30434782608695654
rbXH979_NS8,8,8,2,18,0.4444444444444444,0.4444444444444444,0.4444444444444444
rdG3GzE_5Ms,19,31,1,51,0.37254901960784315,0.37254901960784315,0.6078431372549019
rdY5kw09M10,4,10,2,16,0.25,0.25,0.625
reGfgxpl3AM,8,23,0,31,0.25806451612903225,0.25806451612903225,0.7419354838709677
rfqLRGtMw-c,9,7,3,19,0.47368421052631576,0.47368421052631576,0.3684210526315789
rg5xTzr6DHM,39,21,2,62,0.6290322580645161,0.6290322580645161,0.3387096774193548
rgeDAomY3MM,11,3,1,15,0.7333333333333333,0.7333333333333333,0.2
rgkoaUYfEXU,2,6,0,8,0.25,0.25,0.75
rhTLvclwkvg,13,28,1,42,0.30952380952380953,0.30952380952380953,0.6666666666666666
rhhhXJZWodo,195,352,43,590,0.3305084745762712,0.3305084745762712,0.5966101694915255
riV-IAx9QJI,23,27,6,56,0.4107142857142857,0.4107142857142857,0.48214285714285715
rmu1R1leUOE,9,38,2,49,0.1836734693877551,0.1836734693877551,0.7755102040816326
roGWyTNjSuQ,23,12,4,39,0.5897435897435898,0.5897435897435898,0.3076923076923077
roo18lawtb4,14,16,0,30,0.4666666666666667,0.4666666666666667,0.5333333333333333
rp00goz5aHU,2,3,0,5,0.4,0.4,0.6
rq-zXG3_-PM,30,50,6,86,0.3488372093023256,0.3488372093023256,0.5813953488372093
rq5nNSMpqNQ,23,29,7,59,0.3898305084745763,0.3898305084745763,0.4915254237288136
rq9djLVMN7w,21,22,4,47,0.44680851063829785,0.44680851063829785,0.46808510638297873
rrin1m-WUgE,2,10,0,12,0.16666666666666666,0.16666666666666666,0.8333333333333334
rtUoun6iKkA,70,76,9,155,0.45161290322580644,0.45161290322580644,0.49032258064516127
rtnsnVFlkF0,5,14,3,22,0.22727272727272727,0.22727272727272727,0.6363636363636364
ruEzLwLD3i4,23,31,5,59,0.3898305084745763,0.3898305084745763,0.5254237288135594
rufbngYrPtc,4,5,0,9,0.4444444444444444,0.4444444444444444,0.5555555555555556
rupq4E6nRW0,3,9,1,13,0.23076923076923078,0.23076923076923078,0.6923076923076923
ruy4W2gLZtU,17,46,3,66,0.25757575757575757,0.25757575757575757,0.696969696969697
rxr8vyHjHik,2,4,1,7,0.2857142857142857,0.2857142857142857,0.5714285714285714
ryLgZc17NyU,5,7,1,13,0.38461538461538464,0.38461538461538464,0.5384615384615384
ryZ7358B4UY,8,3,2,13,0.6153846153846154,0.6153846153846154,0.23076923076923078
rzBT4otJciY,25,97,23,145,0.1724137931034483,0.1724137931034483,0.6689655172413793
rzKGEfVr_Zw,6,29,3,38,0.15789473684210525,0.15789473684210525,0.7631578947368421
rzP4QAtXdWA,6,20,2,28,0.21428571428571427,0.21428571428571427,0.7142857142857143
s-7hZ_xBvfc,29,23,8,60,0.48333333333333334,0.48333333333333334,0.38333333333333336
s-88EqLtKrA,11,26,2,39,0.28205128205128205,0.28205128205128205,0.6666666666666666
s1H6xLmuEXA,10,15,2,27,0.37037037037037035,0.37037037037037035,0.5555555555555556
s1_BkUAqtJo,15,49,8,72,0.20833333333333334,0.20833333333333334,0.6805555555555556
s1gYv8toGDs,5,15,2,22,0.22727272727272727,0.22727272727272727,0.6818181818181818
s2PnmcAu6Fw,1,5,1,7,0.14285714285714285,0.14285714285714285,0.7142857142857143
s2T4F9GSbjU,8,14,0,22,0.36363636363636365,0.36363636363636365,0.6363636363636364
s4fCJ31C0zU,16,26,5,47,0.3404255319148936,0.3404255319148936,0.5531914893617021
s5TlLnBSoA8,7,28,1,36,0.19444444444444445,0.19444444444444445,0.7777777777777778
s87DL_tEXQ4,29,26,1,56,0.5178571428571429,0.5178571428571429,0.4642857142857143
s8IrxlwvXI8,7,13,0,20,0.35,0.35,0.65
sAzrc5YSdt0,6,9,2,17,0.35294117647058826,0.35294117647058826,0.5294117647058824
sBCntc6IyZg,3,45,3,51,0.058823529411764705,0.058823529411764705,0.8823529411764706
sD8HZKUTSiE,27,42,6,75,0.36,0.36,0.56
sDv2SHC3WYU,15,44,9,68,0.22058823529411764,0.22058823529411764,0.6470588235294118
sElXwqfM7Go,25,34,4,63,0.3968253968253968,0.3968253968253968,0.5396825396825397
sFX_W6AzPeI,35,39,8,82,0.4268292682926829,0.4268292682926829,0.47560975609756095
sFp_zXr2x9U,22,109,8,139,0.15827338129496402,0.15827338129496402,0.7841726618705036
sHfxejbkBtY,2,4,1,7,0.2857142857142857,0.2857142857142857,0.5714285714285714
sHtTlxviZ3g,2,13,1,16,0.125,0.125,0.8125
sIp5oUcNgnY,28,37,3,68,0.4117647058823529,0.4117647058823529,0.5441176470588235
sJjKTM6SypY,9,40,3,52,0.17307692307692307,0.17307692307692307,0.7692307692307693
sJm17DPf4kY,7,20,1,28,0.25,0.25,0.7142857142857143
sK6Jv2RLgX0,6,14,5,25,0.24,0.24,0.56
sKUvwOX4i8s,16,91,2,109,0.14678899082568808,0.14678899082568808,0.8348623853211009
sLSABWuiXdE,28,163,9,200,0.14,0.14,0.815
sLdHmS_lHAg,4,21,0,25,0.16,0.16,0.84
sNplfdCxkFw,17,45,1,63,0.2698412698412698,0.2698412698412698,0.7142857142857143
sQyr1lIsoWs,10,15,1,26,0.38461538461538464,0.38461538461538464,0.5769230769230769
sSG129rt1wU,7,7,0,14,0.5,0.5,0.5
sSoeI31PSxA,1,8,3,12,0.08333333333333333,0.08333333333333333,0.6666666666666666
sU4X0qDcPpM,8,32,8,48,0.16666666666666666,0.16666666666666666,0.6666666666666666
sVYOckC-JaE,12,19,1,32,0.375,0.375,0.59375
sVylvz5Igvs,15,14,7,36,0.4166666666666667,0.4166666666666667,0.3888888888888889
sX6OU0QxYjc,12,24,3,39,0.3076923076923077,0.3076923076923077,0.6153846153846154
sY8eQV8lPLs,3,16,5,24,0.125,0.125,0.6666666666666666
sYLsUWJVFMo,2,11,1,14,0.14285714285714285,0.14285714285714285,0.7857142857142857
sY_9n41Gc8s,14,10,1,25,0.56,0.56,0.4
sZPVYVsq00g,2,10,1,13,0.15384615384615385,0.15384615384615385,0.7692307692307693
s_RaS-v-9es,8,16,1,25,0.32,0.32,0.64
saPOH9rpGqY,61,47,14,122,0.5,0.5,0.38524590163934425
sb5LqlBYH5M,17,11,0,28,0.6071428571428571,0.6071428571428571,0.39285714285714285
sbvLqZGx8zs,1,1,3,5,0.2,0.2,0.2
sc8RZwQuYv0,4,5,1,10,0.4,0.4,0.5
sd2Va5CnlBM,9,39,3,51,0.17647058823529413,0.17647058823529413,0.7647058823529411
sdufbgp86Cc,8,14,6,28,0.2857142857142857,0.2857142857142857,0.5
sdy3KO1olik,6,13,1,20,0.3,0.3,0.65
se1DE6qVzOk,5,38,4,47,0.10638297872340426,0.10638297872340426,0.8085106382978723
sfWUbE7q8dA,0,13,2,15,0,0,0.8666666666666667
shCHWy-oJQw,4,5,0,9,0.4444444444444444,0.4444444444444444,0.5555555555555556
shWH4CfYn8c,94,76,9,179,0.5251396648044693,0.5251396648044693,0.4245810055865922
sjqw8JLDpZY,8,5,0,13,0.6153846153846154,0.6153846153846154,0.38461538461538464
skBi8gtiGDY,5,21,0,26,0.19230769230769232,0.19230769230769232,0.8076923076923077
sli8Ttiiw8M,16,14,0,30,0.5333333333333333,0.5333333333333333,0.4666666666666667
smCFk16qzFI,10,16,3,29,0.3448275862068966,0.3448275862068966,0.5517241379310345
sn92H7O1XgM,7,4,1,12,0.5833333333333334,0.5833333333333334,0.3333333333333333
spilEISTUe0,37,123,10,170,0.21764705882352942,0.21764705882352942,0.7235294117647059
sqAk44qE_Mw,20,68,10,98,0.20408163265306123,0.20408163265306123,0.6938775510204082
sqnuc93ok_k,5,12,0,17,0.29411764705882354,0.29411764705882354,0.7058823529411765
ssvQ-bCj0XE,8,19,1,28,0.2857142857142857,0.2857142857142857,0.6785714285714286
stYBPFHjXiI,7,7,1,15,0.4666666666666667,0.4666666666666667,0.4666666666666667
su3g4DV7MnY,12,17,6,35,0.34285714285714286,0.34285714285714286,0.4857142857142857
suj9WCBt_y4,25,32,1,58,0.43103448275862066,0.43103448275862066,0.5517241379310345
sv3yHa8soTY,5,6,3,14,0.35714285714285715,0.35714285714285715,0.42857142857142855
swAIdd8SoSs,53,62,13,128,0.4140625,0.4140625,0.484375
swogXvRwXKc,18,43,5,66,0.2727272727272727,0.2727272727272727,0.6515151515151515
sxXegl6gsCI,8,27,3,38,0.21052631578947367,0.21052631578947367,0.7105263157894737
sxrK___uUSA,10,12,1,23,0.43478260869565216,0.43478260869565216,0.5217391304347826
sytx45BQYW0,7,15,4,26,0.2692307692307692,0.2692307692307692,0.5769230769230769
szGhe-bGNn8,5,27,3,35,0.14285714285714285,0.14285714285714285,0.7714285714285715
szOxR40ONNA,3,7,1,11,0.2727272727272727,0.2727272727272727,0.6363636363636364
szPwlNQZCsk,4,19,1,24,0.16666666666666666,0.16666666666666666,0.7916666666666666
t-Z9Kua3F1M,6,26,1,33,0.18181818181818182,0.18181818181818182,0.7878787878787878
t-qm-t9nA8k,7,10,0,17,0.4117647058823529,0.4117647058823529,0.5882352941176471
t47CgesYetY,50,77,6,133,0.37593984962406013,0.37593984962406013,0.5789473684210527
t4HTnaH9j2I,75,40,12,127,0.5905511811023622,0.5905511811023622,0.31496062992125984
t5qle1wyFOI,59,263,19,341,0.17302052785923755,0.17302052785923755,0.7712609970674487
t6UgShnDl7g,2,15,1,18,0.1111111111111111,0.1111111111111111,0.8333333333333334
t6hkT9S4CKQ,95,53,11,159,0.5974842767295597,0.5974842767295597,0.3333333333333333
t71n6MxMF2Y,4,6,1,11,0.36363636363636365,0.36363636363636365,0.5454545454545454
t7UtR-har1w,16,20,3,39,0.41025641025641024,0.41025641025641024,0.5128205128205128
t7YI8bjxSKc,12,9,1,22,0.5454545454545454,0.5454545454545454,0.4090909090909091
t9yVaCFtWUw,32,15,4,51,0.6274509803921569,0.6274509803921569,0.29411764705882354
tApt15pPjsY,14,24,2,40,0.35,0.35,0.6
tCvyo2MyAWk,10,22,0,32,0.3125,0.3125,0.6875
tFxMyoGu8uU,7,11,3,21,0.3333333333333333,0.3333333333333333,0.5238095238095238
tIU14xSG81U,17,29,5,51,0.3333333333333333,0.3333333333333333,0.5686274509803921
tIYHCOIMcDg,0,1,0,1,0,0,1
tIkKNrJeevI,13,39,0,52,0.25,0.25,0.75
tJLKKNp8jUQ,5,3,0,8,0.625,0.625,0.375
tJbhXhh0H-4,12,11,1,24,0.5,0.5,0.4583333333333333
tK9cgPqcZMs,5,24,2,31,0.16129032258064516,0.16129032258064516,0.7741935483870968
tKfBUJgoYw4,59,48,19,126,0.46825396825396826,0.46825396825396826,0.38095238095238093
tLF8_jQFNGY,23,52,6,81,0.2839506172839506,0.2839506172839506,0.6419753086419753
tLIi15rwKFk,16,21,1,38,0.42105263157894735,0.42105263157894735,0.5526315789473685
tLXqqjG_b64,29,125,12,166,0.1746987951807229,0.1746987951807229,0.7530120481927711
tOF2c3OTDT0,11,15,2,28,0.39285714285714285,0.39285714285714285,0.5357142857142857
tQ6dD4KJ7SU,8,38,4,50,0.16,0.16,0.76
tQinetIn1nI,171,548,72,791,0.21618204804045513,0.21618204804045513,0.6927939317319848
tSZlhp7zxZA,11,9,2,22,0.5,0.5,0.4090909090909091
tTBHkGWGJak,127,124,13,264,0.4810606060606061,0.4810606060606061,0.4696969696969697
tTpL-p3oJEI,1,5,1,7,0.14285714285714285,0.14285714285714285,0.7142857142857143
tUyamvSYbBQ,45,53,2,100,0.45,0.45,0.53
tV4FN4QjgC4,13,13,1,27,0.48148148148148145,0.48148148148148145,0.48148148148148145
tVXVOo-fF5A,4,28,4,36,0.1111111111111111,0.1111111111111111,0.7777777777777778
tVcWxAEY6v8,9,7,0,16,0.5625,0.5625,0.4375
tWezFKW0S54,11,18,4,33,0.3333333333333333,0.3333333333333333,0.5454545454545454
tYfFiUxoigE,46,202,16,264,0.17424242424242425,0.17424242424242425,0.7651515151515151
tYjdhAiMeYA,10,14,9,33,0.30303030303030304,0.30303030303030304,0.42424242424242425
t_I-ldTkKzc,3,3,0,6,0.5,0.5,0.5
t_JWLbGCXfw,6,3,0,9,0.6666666666666666,0.6666666666666666,0.3333333333333333
t_bdls2akEI,6,25,1,32,0.1875,0.1875,0.78125
t_noBfvW2Ao,3,5,3,11,0.2727272727272727,0.2727272727272727,0.45454545454545453
tc04zRqDTDE,21,36,2,59,0.3559322033898305,0.3559322033898305,0.6101694915254238
tcmmgGit18c,53,40,7,100,0.53,0.53,0.4
td2vbNQk0as,6,3,4,13,0.46153846153846156,0.46153846153846156,0.23076923076923078
td9FYUUKshk,6,5,0,11,0.5454545454545454,0.5454545454545454,0.45454545454545453
te6k6J6NXJw,12,38,7,57,0.21052631578947367,0.21052631578947367,0.6666666666666666
tfF4q_D-txU,45,30,3,78,0.5769230769230769,0.5769230769230769,0.38461538461538464
tfIlSkB5iM8,11,24,2,37,0.2972972972972973,0.2972972972972973,0.6486486486486487
tgBPtUfgUzk,40,30,7,77,0.5194805194805194,0.5194805194805194,0.38961038961038963
tgIrIAwjPCI,45,136,30,211,0.2132701421800948,0.2132701421800948,0.6445497630331753
thnm8SPFWhM,14,17,4,35,0.4,0.4,0.4857142857142857
tn861a3NcVA,53,5,0,58,0.9137931034482759,0.9137931034482759,0.08620689655172414
tnCaLIQAPqo,39,19,2,60,0.65,0.65,0.31666666666666665
tpRg4gCGPkY,4,1,0,5,0.8,0.8,0.2
trmkYDXnvuY,0,3,0,3,0,0,1
tx62-gM9V4g,26,26,7,59,0.4406779661016949,0.4406779661016949,0.4406779661016949
txBICaXQ3-0,28,58,2,88,0.3181818181818182,0.3181818181818182,0.6590909090909091
txCp09GLnB0,3,19,0,22,0.13636363636363635,0.13636363636363635,0.8636363636363636
ty7xm0U-8hs,9,52,2,63,0.14285714285714285,0.14285714285714285,0.8253968253968254
tzXbJg-YmjA,71,201,53,325,0.21846153846153846,0.21846153846153846,0.6184615384615385
tzblrzjSDt4,9,9,1,19,0.47368421052631576,0.47368421052631576,0.47368421052631576
u-8rbOCnQrs,32,33,12,77,0.4155844155844156,0.4155844155844156,0.42857142857142855
u-wz3_pM8SQ,13,12,2,27,0.48148148148148145,0.48148148148148145,0.4444444444444444
u1Tgk2L4eZw,9,12,3,24,0.375,0.375,0.5
u2S6KOSwACw,134,227,9,370,0.3621621621621622,0.3621621621621622,0.6135135135135135
u3JrJkdNdEg,10,4,0,14,0.7142857142857143,0.7142857142857143,0.2857142857142857
u55cjzT1XRo,12,26,3,41,0.2926829268292683,0.2926829268292683,0.6341463414634146
u5milY_JsmA,220,188,17,425,0.5176470588235295,0.5176470588235295,0.4423529411764706
u6foaxMfoZ8,14,16,3,33,0.42424242424242425,0.42424242424242425,0.48484848484848486
u7kAR141XhU,1,0,0,1,1,1,0
u7lR1feiN2w,1,2,0,3,0.3333333333333333,0.3333333333333333,0.6666666666666666
u7m6Tv14b8w,13,25,6,44,0.29545454545454547,0.29545454545454547,0.5681818181818182
uA4h3ppTEkQ,7,9,0,16,0.4375,0.4375,0.5625
uAHW6C6ZbZ4,10,9,4,23,0.43478260869565216,0.43478260869565216,0.391304347826087
uCm6bGGBruU,1,6,0,7,0.14285714285714285,0.14285714285714285,0.8571428571428571
uCvCW0L1kb0,157,366,18,541,0.2902033271719039,0.2902033271719039,0.6765249537892791
uDNUNtTHokg,246,908,127,1281,0.1920374707259953,0.1920374707259953,0.7088212334113974
uDpE-gvvsgc,0,8,1,9,0,0,0.8888888888888888
uEGwCv-EcIc,22,36,1,59,0.3728813559322034,0.3728813559322034,0.6101694915254238
uFIqDly24sI,5,15,6,26,0.19230769230769232,0.19230769230769232,0.5769230769230769
uG64mjXb6q8,22,12,3,37,0.5945945945945946,0.5945945945945946,0.32432432432432434
uGRF_4cbXa8,14,28,1,43,0.32558139534883723,0.32558139534883723,0.6511627906976745
uHmGum6Msnc,20,12,0,32,0.625,0.625,0.375
uNe0cf3NlHQ,7,18,2,27,0.25925925925925924,0.25925925925925924,0.6666666666666666
uNonOgXNnj0,14,63,8,85,0.16470588235294117,0.16470588235294117,0.7411764705882353
uOKcBgiS0P4,42,15,3,60,0.7,0.7,0.25
uOSyNAlSrqI,128,79,9,216,0.5925925925925926,0.5925925925925926,0.36574074074074076
uOzpYNAr5VQ,18,95,3,116,0.15517241379310345,0.15517241379310345,0.8189655172413793
uPRpOnNw6R8,10,19,3,32,0.3125,0.3125,0.59375
uQSlwjFjtsI,41,82,6,129,0.3178294573643411,0.3178294573643411,0.6356589147286822
uQVaRHJ3oyE,2,2,1,5,0.4,0.4,0.4
uRRNNT3uADc,13,18,2,33,0.3939393939393939,0.3939393939393939,0.5454545454545454
uRYAYFUvnK8,56,80,7,143,0.3916083916083916,0.3916083916083916,0.5594405594405595
uRjvALLOsbM,1,2,0,3,0.3333333333333333,0.3333333333333333,0.6666666666666666
uRtsMRT4F9k,5,12,0,17,0.29411764705882354,0.29411764705882354,0.7058823529411765
uSfQqhS3y0g,35,54,8,97,0.36082474226804123,0.36082474226804123,0.5567010309278351
uSqFVxrym78,7,43,3,53,0.1320754716981132,0.1320754716981132,0.8113207547169812
uTlHzIPYEOw,6,31,3,40,0.15,0.15,0.775
uV_XYFQfP2A,34,58,5,97,0.35051546391752575,0.35051546391752575,0.5979381443298969
uVeeljyVcCg,26,10,0,36,0.7222222222222222,0.7222222222222222,0.2777777777777778
uWI_3RvZfVw,55,71,7,133,0.41353383458646614,0.41353383458646614,0.5338345864661654
uWf-395Iofc,13,62,3,78,0.16666666666666666,0.16666666666666666,0.7948717948717948
uZ9mevDTTBI,2,9,2,13,0.15384615384615385,0.15384615384615385,0.6923076923076923
uZVuOeqxw1I,22,94,8,124,0.1774193548387097,0.1774193548387097,0.7580645161290323
uZZiv0IAnMk,200,83,4,287,0.6968641114982579,0.6968641114982579,0.289198606271777
u_adW1JZGpI,5,11,0,16,0.3125,0.3125,0.6875
uaWJRRIUhcU,19,19,3,41,0.4634146341463415,0.4634146341463415,0.4634146341463415
uasZPfg2MlA,13,22,1,36,0.3611111111111111,0.3611111111111111,0.6111111111111112
ub48NR2aqjw,13,13,2,28,0.4642857142857143,0.4642857142857143,0.4642857142857143
ubfn3mYFk9g,1,23,0,24,0.041666666666666664,0.041666666666666664,0.9583333333333334
udpQgJH77tQ,34,21,8,63,0.5396825396825397,0.5396825396825397,0.3333333333333333
ueKwz0JFrYY,4,6,2,12,0.3333333333333333,0.3333333333333333,0.5
uecc16pPK_o,12,38,1,51,0.23529411764705882,0.23529411764705882,0.7450980392156863
ugzu4huvTOk,5,32,3,40,0.125,0.125,0.8
uh17eHKa7c8,4,16,2,22,0.18181818181818182,0.18181818181818182,0.7272727272727273
uhrD3QMH6cY,10,15,0,25,0.4,0.4,0.6
uiGf6IhyhnM,22,37,6,65,0.3384615384615385,0.3384615384615385,0.5692307692307692
uipyboiCa7Q,55,79,14,148,0.3716216216216216,0.3716216216216216,0.5337837837837838
uirKfq_VlpQ,24,20,2,46,0.5217391304347826,0.5217391304347826,0.43478260869565216
ulHLLi3Hxz0,9,5,1,15,0.6,0.6,0.3333333333333333
unRMgvj52gs,79,84,13,176,0.44886363636363635,0.44886363636363635,0.4772727272727273
unuEs8sqnrw,19,37,1,57,0.3333333333333333,0.3333333333333333,0.6491228070175439
uoHEPDok1K0,18,13,3,34,0.5294117647058824,0.5294117647058824,0.38235294117647056
uoyQlX-jyOA,4,8,0,12,0.3333333333333333,0.3333333333333333,0.6666666666666666
up_sMNaowK4,3,15,1,19,0.15789473684210525,0.15789473684210525,0.7894736842105263
upzpGNAUwqs,7,4,4,15,0.4666666666666667,0.4666666666666667,0.26666666666666666
uqJBrU6d0JI,8,9,0,17,0.47058823529411764,0.47058823529411764,0.5294117647058824
uqqTzLvwUGs,374,946,177,1497,0.24983299933199732,0.24983299933199732,0.6319305277221109
urhFNGYyzWQ,0,2,0,2,0,0,1
usgzzLkYous,6,15,3,24,0.25,0.25,0.625
utHOFLeM2TQ,180,36,7,223,0.8071748878923767,0.8071748878923767,0.16143497757847533
uu7gwyn1NpU,5,7,3,15,0.3333333333333333,0.3333333333333333,0.4666666666666667
uuUJopU68Lc,1,0,0,1,1,1,0
uvY3GwQNbHs,7,36,7,50,0.14,0.14,0.72
uz3lIZ9n3Is,6,14,3,23,0.2608695652173913,0.2608695652173913,0.6086956521739131
v-13G5WHWJA,80,288,22,390,0.20512820512820512,0.20512820512820512,0.7384615384615385
v14O1F9XhwI,2,6,1,9,0.2222222222222222,0.2222222222222222,0.6666666666666666
v1lTt6Hv4yg,11,12,2,25,0.44,0.44,0.48
v2iMc5lQUbU,0,1,0,1,0,0,1
v51lWmHsl78,11,12,1,24,0.4583333333333333,0.4583333333333333,0.5
v5WtJ540xjM,24,13,7,44,0.5454545454545454,0.5454545454545454,0.29545454545454547
v6tUExZcyJk,7,5,0,12,0.5833333333333334,0.5833333333333334,0.4166666666666667
v79qv2wyZAc,8,13,2,23,0.34782608695652173,0.34782608695652173,0.5652173913043478
v7gnIWO3Yfg,20,74,3,97,0.20618556701030927,0.20618556701030927,0.7628865979381443
v9bZGI19E5Y,10,22,2,34,0.29411764705882354,0.29411764705882354,0.6470588235294118
v9ijWPOa3H0,42,37,1,80,0.525,0.525,0.4625
v9pmIL2e2io,36,71,7,114,0.3157894736842105,0.3157894736842105,0.6228070175438597
vC9_OWKG6zc,22,38,3,63,0.3492063492063492,0.3492063492063492,0.6031746031746031
vComJbkD1Hw,35,52,5,92,0.3804347826086957,0.3804347826086957,0.5652173913043478
vD6OWZvRxik,3,0,1,4,0.75,0.75,0
vDRpU7w5r8o,6,20,1,27,0.2222222222222222,0.2222222222222222,0.7407407407407407
vFkJ0eeoLtI,1,5,1,7,0.14285714285714285,0.14285714285714285,0.7142857142857143
vFlhNsiuFgw,17,35,4,56,0.30357142857142855,0.30357142857142855,0.625
vFzaMV0a4us,348,1437,106,1891,0.18402961396086726,0.18402961396086726,0.7599153886832364
vHHCe7QEN40,8,24,3,35,0.22857142857142856,0.22857142857142856,0.6857142857142857
vIaRbpZU1lQ,15,29,3,47,0.3191489361702128,0.3191489361702128,0.6170212765957447
vJn6tVxAmL0,2,4,0,6,0.3333333333333333,0.3333333333333333,0.6666666666666666
vJrZORQMLps,8,15,2,25,0.32,0.32,0.6
vL-1eSyBhqA,16,16,0,32,0.5,0.5,0.5
vL_3VoZZnXY,57,103,9,169,0.33727810650887574,0.33727810650887574,0.6094674556213018
vMHhlyC-SPI,11,41,1,53,0.20754716981132076,0.20754716981132076,0.7735849056603774
vMImoj4AtIM,3,6,0,9,0.3333333333333333,0.3333333333333333,0.6666666666666666
vOpqpJJk91c,0,1,0,1,0,0,1
vPtoZI62A10,23,137,12,172,0.13372093023255813,0.13372093023255813,0.7965116279069767
vPxY-JlBYyI,1,1,1,3,0.3333333333333333,0.3333333333333333,0.3333333333333333
vQ6yAypEpsk,31,20,1,52,0.5961538461538461,0.5961538461538461,0.38461538461538464
vQ8ID2NldLU,27,124,11,162,0.16666666666666666,0.16666666666666666,0.7654320987654321
vQrDzp9Ztng,8,8,0,16,0.5,0.5,0.5
vRBMIYoazZM,23,19,0,42,0.5476190476190477,0.5476190476190477,0.4523809523809524
vRHK1kZLeNU,160,192,23,375,0.4266666666666667,0.4266666666666667,0.512
vRR6vpR17Xc,7,0,0,7,1,1,0
vSe3UlzA1c0,3,1,0,4,0.75,0.75,0.25
vWo2oTHDVxI,34,54,15,103,0.3300970873786408,0.3300970873786408,0.5242718446601942
vXyYCX_LDSM,18,76,6,100,0.18,0.18,0.76
vZ44BWFAvJg,48,322,15,385,0.12467532467532468,0.12467532467532468,0.8363636363636363
v_UXBQ52MtM,6,27,2,35,0.17142857142857143,0.17142857142857143,0.7714285714285715
v_ayoczJ4EA,5,3,0,8,0.625,0.625,0.375
vasbdfFSoGg,44,314,21,379,0.11609498680738786,0.11609498680738786,0.8284960422163589
vbYwJRs4lE8,2,2,0,4,0.5,0.5,0.5
vbrNhmuX6CU,6,58,11,75,0.08,0.08,0.7733333333333333
vcBL1zevLU8,21,7,2,30,0.7,0.7,0.23333333333333334
vcUhSrGst2w,4,7,0,11,0.36363636363636365,0.36363636363636365,0.6363636363636364
vdZ-qLvekEY,30,41,5,76,0.39473684210526316,0.39473684210526316,0.5394736842105263
vetaNb3IEe4,16,21,0,37,0.43243243243243246,0.43243243243243246,0.5675675675675675
vfbNuWiKtO4,7,18,1,26,0.2692307692307692,0.2692307692307692,0.6923076923076923
vhWZYIiBiQg,6,8,1,15,0.4,0.4,0.5333333333333333
vihVJQ4gNGc,1,1,0,2,0.5,0.5,0.5
vj5RZgMg7T8,12,29,1,42,0.2857142857142857,0.2857142857142857,0.6904761904761905
vk7C3WqHxac,15,43,3,61,0.2459016393442623,0.2459016393442623,0.7049180327868853
vl1QwuqSaEI,22,11,3,36,0.6111111111111112,0.6111111111111112,0.3055555555555556
vmacCr4Y3LE,33,52,2,87,0.3793103448275862,0.3793103448275862,0.5977011494252874
vmdG81soHWQ,3,7,1,11,0.2727272727272727,0.2727272727272727,0.6363636363636364
voEciFDQfE0,7,1,0,8,0.875,0.875,0.125
vpGwUsfeH7E,51,32,4,87,0.5862068965517241,0.5862068965517241,0.367816091954023
vpy9SwpvUOs,29,58,1,88,0.32954545454545453,0.32954545454545453,0.6590909090909091
vrCv4MDeIWM,6,19,1,26,0.23076923076923078,0.23076923076923078,0.7307692307692307
vrIbKJeU4gY,5,37,0,42,0.11904761904761904,0.11904761904761904,0.8809523809523809
vs763ccFTDM,21,19,5,45,0.4666666666666667,0.4666666666666667,0.4222222222222222
vs_Jiid33AY,21,30,3,54,0.3888888888888889,0.3888888888888889,0.5555555555555556
vtdG_pZF4iA,53,48,3,104,0.5096153846153846,0.5096153846153846,0.46153846153846156
vtdJLK5K82o,34,44,1,79,0.43037974683544306,0.43037974683544306,0.5569620253164557
vtgfB5s7nyU,8,14,1,23,0.34782608695652173,0.34782608695652173,0.6086956521739131
vuqhSaDIvKw,11,2,0,13,0.8461538461538461,0.8461538461538461,0.15384615384615385
vwW6ZVO0wx4,5,10,2,17,0.29411764705882354,0.29411764705882354,0.5882352941176471
w-H8dOx7Pk4,19,86,10,115,0.16521739130434782,0.16521739130434782,0.7478260869565218
w-OM6whxbCo,20,10,4,34,0.5882352941176471,0.5882352941176471,0.29411764705882354
w0ftPYIBD7U,4,5,1,10,0.4,0.4,0.5
w1G1SwKoIKE,11,7,2,20,0.55,0.55,0.35
w1bHl5XGMe8,5,3,1,9,0.5555555555555556,0.5555555555555556,0.3333333333333333
w22TdaBQyHQ,56,97,27,180,0.3111111111111111,0.3111111111111111,0.5388888888888889
w28FQbn4Isk,38,53,8,99,0.3838383838383838,0.3838383838383838,0.5353535353535354
w2LF9rYLO4A,28,45,11,84,0.3333333333333333,0.3333333333333333,0.5357142857142857
w3j8xNozxAk,8,20,2,30,0.26666666666666666,0.26666666666666666,0.6666666666666666
w3zU5EQwc6E,7,39,4,50,0.14,0.14,0.78
w5TIC0MO7r0,90,68,9,167,0.5389221556886228,0.5389221556886228,0.40718562874251496
w5mJmr0xq24,5,31,1,37,0.13513513513513514,0.13513513513513514,0.8378378378378378
w7W1nqnvShE,46,19,4,69,0.6666666666666666,0.6666666666666666,0.2753623188405797
w8TZhr1htRQ,57,230,22,309,0.18446601941747573,0.18446601941747573,0.7443365695792881
w8pvweX1exk,4,11,1,16,0.25,0.25,0.6875
w9sRwtMa3uU,31,132,13,176,0.17613636363636365,0.17613636363636365,0.75
wAk7z8eE1sk,21,50,7,78,0.2692307692307692,0.2692307692307692,0.6410256410256411
wBpBeimaRHI,1,23,1,25,0.04,0.04,0.92
wCCxOJSJ3uE,9,22,0,31,0.2903225806451613,0.2903225806451613,0.7096774193548387
wE-iytqSO0s,16,49,0,65,0.24615384615384617,0.24615384615384617,0.7538461538461538
wFmqBl-EmZk,12,20,1,33,0.36363636363636365,0.36363636363636365,0.6060606060606061
wFsygZPVW0A,13,40,3,56,0.23214285714285715,0.23214285714285715,0.7142857142857143
wHePmsYSVUI,25,19,4,48,0.5208333333333334,0.5208333333333334,0.3958333333333333
wJhy8M0nWRM,28,25,5,58,0.4827586206896552,0.4827586206896552,0.43103448275862066
wK7xVcjfb8I,5,23,4,32,0.15625,0.15625,0.71875
wLCSQpItcnk,2,5,1,8,0.25,0.25,0.625
wMyFupG30fY,1,4,0,5,0.2,0.2,0.8
wN-nrhqo47Y,1,2,0,3,0.3333333333333333,0.3333333333333333,0.6666666666666666
wOsgrofdAEU,14,20,1,35,0.4,0.4,0.5714285714285714
wRJGQCR34-c,179,457,101,737,0.24287652645861602,0.24287652645861602,0.6200814111261872
wTCrUPGYdyc,16,12,2,30,0.5333333333333333,0.5333333333333333,0.4
wTHWzEjClZI,9,6,1,16,0.5625,0.5625,0.375
wUKaeSmcj_U,2,15,2,19,0.10526315789473684,0.10526315789473684,0.7894736842105263
wW_FqXVe_3U,21,74,7,102,0.20588235294117646,0.20588235294117646,0.7254901960784313
wWcCxVT0e5o,4,8,0,12,0.3333333333333333,0.3333333333333333,0.6666666666666666
wWrriktBIwc,67,125,7,199,0.33668341708542715,0.33668341708542715,0.628140703517588
wXW3RaH6HEs,6,41,9,56,0.10714285714285714,0.10714285714285714,0.7321428571428571
w_lGYw8oupE,4,45,4,53,0.07547169811320754,0.07547169811320754,0.8490566037735849
waf_1S_1mdE,7,8,2,17,0.4117647058823529,0.4117647058823529,0.47058823529411764
wbaK17TGM94,11,23,1,35,0.3142857142857143,0.3142857142857143,0.6571428571428571
wbkWCX_9M1A,0,9,0,9,0,0,1
wcKIgdL5dPQ,15,13,2,30,0.5,0.5,0.43333333333333335
wcaRl8K5adE,5,8,0,13,0.38461538461538464,0.38461538461538464,0.6153846153846154
we4MQRUQpWc,9,4,0,13,0.6923076923076923,0.6923076923076923,0.3076923076923077
weZksTuXTmI,2,6,1,9,0.2222222222222222,0.2222222222222222,0.6666666666666666
weeztDxJDtQ,3,5,1,9,0.3333333333333333,0.3333333333333333,0.5555555555555556
whLN-sQmb40,8,65,0,73,0.1095890410958904,0.1095890410958904,0.8904109589041096
wjhyOJOcqU4,18,20,2,40,0.45,0.45,0.5
wkZn9LGD3xk,33,26,4,63,0.5238095238095238,0.5238095238095238,0.4126984126984127
wmHLcXWCSyk,2,13,0,15,0.13333333333333333,0.13333333333333333,0.8666666666666667
wo2EHrWP4gk,38,48,1,87,0.4367816091954023,0.4367816091954023,0.5517241379310345
wpnumHX6tD4,13,32,2,47,0.2765957446808511,0.2765957446808511,0.6808510638297872
wqKQR_3C63Y,14,9,3,26,0.5384615384615384,0.5384615384615384,0.34615384615384615
wtno_j27tQE,71,110,38,219,0.3242009132420091,0.3242009132420091,0.502283105022831
wyBLhmARCRI,2,0,0,2,1,1,0
wzh9PuDA_4s,44,58,5,107,0.411214953271028,0.411214953271028,0.5420560747663551
wzt8AFPfpiM,7,1,0,8,0.875,0.875,0.125
x0SXVTXtMgc,11,14,2,27,0.4074074074074074,0.4074074074074074,0.5185185185185185
x0_r3zYga5s,7,13,2,22,0.3181818181818182,0.3181818181818182,0.5909090909090909
x1KuaWIPL_Y,4,4,0,8,0.5,0.5,0.5
x1nkO_2UA5Y,15,12,3,30,0.5,0.5,0.4
x1uffZAXdHg,37,93,14,144,0.2569444444444444,0.2569444444444444,0.6458333333333334
x23LCW6lR84,14,18,8,40,0.35,0.35,0.45
x31BMuDcKto,20,16,1,37,0.5405405405405406,0.5405405405405406,0.43243243243243246
x31EP3bmjvs,5,32,1,38,0.13157894736842105,0.13157894736842105,0.8421052631578947
x55uQsQnrF4,2,4,1,7,0.2857142857142857,0.2857142857142857,0.5714285714285714
x6_vvTIpr6w,41,85,5,131,0.31297709923664124,0.31297709923664124,0.648854961832061
x7OA6yn13as,15,17,1,33,0.45454545454545453,0.45454545454545453,0.5151515151515151
x7p80lZiiRE,12,54,2,68,0.17647058823529413,0.17647058823529413,0.7941176470588235
x7ua6vCXhNk,85,82,20,187,0.45454545454545453,0.45454545454545453,0.4385026737967914
xAyrPnUiLII,10,22,1,33,0.30303030303030304,0.30303030303030304,0.6666666666666666
xBKDV_NeC4I,5,10,2,17,0.29411764705882354,0.29411764705882354,0.5882352941176471
xCg0pnTa4N0,31,74,16,121,0.256198347107438,0.256198347107438,0.6115702479338843
xDDk4NtolCg,32,36,2,70,0.45714285714285713,0.45714285714285713,0.5142857142857142
xFQtGzqwcGU,8,58,5,71,0.11267605633802817,0.11267605633802817,0.8169014084507042
xGl2YzJzgdA,44,83,5,132,0.3333333333333333,0.3333333333333333,0.6287878787878788
xHhau-pKOMs,55,39,5,99,0.5555555555555556,0.5555555555555556,0.3939393939393939
xHqjX8XlGVE,18,26,2,46,0.391304347826087,0.391304347826087,0.5652173913043478
xIbKrWcJcVA,5,4,1,10,0.5,0.5,0.4
xJGMkqgvARg,2,10,1,13,0.15384615384615385,0.15384615384615385,0.7692307692307693
xKSUqbo2AwY,4,11,0,15,0.26666666666666666,0.26666666666666666,0.7333333333333333
xLxT2cwgsGA,1,2,0,3,0.3333333333333333,0.3333333333333333,0.6666666666666666
xML05JSo7LM,3,7,0,10,0.3,0.3,0.7
xNaEDS5FOXY,2,10,3,15,0.13333333333333333,0.13333333333333333,0.6666666666666666
xNmePKo7Pfg,2,17,1,20,0.1,0.1,0.85
xO60Z7gO6YY,5,4,0,9,0.5555555555555556,0.5555555555555556,0.4444444444444444
xOZ94FiL-7I,42,54,5,101,0.4158415841584158,0.4158415841584158,0.5346534653465347
xPKr7Mc6i9I,4,10,1,15,0.26666666666666666,0.26666666666666666,0.6666666666666666
xQMndrg8UH0,13,25,5,43,0.3023255813953488,0.3023255813953488,0.5813953488372093
xU81ikzmUsM,109,209,25,343,0.3177842565597668,0.3177842565597668,0.60932944606414
xVFuw0MxXTg,5,6,1,12,0.4166666666666667,0.4166666666666667,0.5
xVJNbJ22tg8,7,12,1,20,0.35,0.35,0.6
xW-mOKth2xM,13,19,2,34,0.38235294117647056,0.38235294117647056,0.5588235294117647
xW5M5uSTudQ,6,25,0,31,0.1935483870967742,0.1935483870967742,0.8064516129032258
xXJRF9FJmos,337,1293,222,1852,0.18196544276457882,0.18196544276457882,0.6981641468682506
xYkbSGAMHr8,11,6,1,18,0.6111111111111112,0.6111111111111112,0.3333333333333333
xYxCh3ZgFJU,8,25,2,35,0.22857142857142856,0.22857142857142856,0.7142857142857143
xZ0BBeEJn0I,14,21,1,36,0.3888888888888889,0.3888888888888889,0.5833333333333334
x_OdZNsFkGA,32,160,11,203,0.15763546798029557,0.15763546798029557,0.7881773399014779
x_g6cjwx23M,5,2,0,7,0.7142857142857143,0.7142857142857143,0.2857142857142857
xaIe_eOWm50,9,5,0,14,0.6428571428571429,0.6428571428571429,0.35714285714285715
xbKKnvfRu6w,8,17,3,28,0.2857142857142857,0.2857142857142857,0.6071428571428571
xcSFDRamaEo,12,20,1,33,0.36363636363636365,0.36363636363636365,0.6060606060606061
xcYMjEl12C8,22,4,3,29,0.7586206896551724,0.7586206896551724,0.13793103448275862
xcYj6SUvTNM,47,43,6,96,0.4895833333333333,0.4895833333333333,0.4479166666666667
xcyz9p175cg,19,13,3,35,0.5428571428571428,0.5428571428571428,0.37142857142857144
xeAqtLfQsJo,11,19,2,32,0.34375,0.34375,0.59375
xelmch9YBv8,4,16,0,20,0.2,0.2,0.8
xf5Ka-mRpi4,3,1,0,4,0.75,0.75,0.25
xhTM2153dqE,95,272,47,414,0.22946859903381642,0.22946859903381642,0.6570048309178744
xjs4vwUo32Y,19,104,15,138,0.13768115942028986,0.13768115942028986,0.7536231884057971
xk5vTQ7edd8,19,34,5,58,0.3275862068965517,0.3275862068965517,0.5862068965517241
xkksO5gIPXw,2,1,0,3,0.6666666666666666,0.6666666666666666,0.3333333333333333
xl2bGBYmRAI,161,304,49,514,0.3132295719844358,0.3132295719844358,0.5914396887159533
xn-Wc-363hk,5,7,1,13,0.38461538461538464,0.38461538461538464,0.5384615384615384
xnlAxDM8eTI,1,12,0,13,0.07692307692307693,0.07692307692307693,0.9230769230769231
xoiwwKnJQzQ,0,5,5,10,0,0,0.5
xpporf8tQ_s,11,7,2,20,0.55,0.55,0.35
xqwbtUHns8A,12,14,1,27,0.4444444444444444,0.4444444444444444,0.5185185185185185
xseR5AumI1s,25,35,1,61,0.4098360655737705,0.4098360655737705,0.5737704918032787
xugUVw0Jfkk,8,19,1,28,0.2857142857142857,0.2857142857142857,0.6785714285714286
xvEQxbUSaEQ,110,63,13,186,0.5913978494623656,0.5913978494623656,0.3387096774193548
xvZjhlgQQd0,3,13,0,16,0.1875,0.1875,0.8125
xw0LSAsJ3kc,8,7,5,20,0.4,0.4,0.35
xx7Batwc7Q0,18,21,3,42,0.42857142857142855,0.42857142857142855,0.5
xxPr-h_Nllk,1,8,1,10,0.1,0.1,0.8
xy4gYYV7vLc,10,54,7,71,0.14084507042253522,0.14084507042253522,0.7605633802816901
xzGiUO_xq8s,4,8,0,12,0.3333333333333333,0.3333333333333333,0.6666666666666666
y05w46G9SqQ,0,13,1,14,0,0,0.9285714285714286
y0qB2AXZR10,49,17,7,73,0.6712328767123288,0.6712328767123288,0.2328767123287671
y18CIRjqKCw,23,31,2,56,0.4107142857142857,0.4107142857142857,0.5535714285714286
y3VYsdNw7JI,6,19,4,29,0.20689655172413793,0.20689655172413793,0.6551724137931034
y3_2jYptusw,3,0,1,4,0.75,0.75,0
y3hZUSSFn0w,22,65,15,102,0.21568627450980393,0.21568627450980393,0.6372549019607843
y5-0QSyqSlY,6,9,2,17,0.35294117647058826,0.35294117647058826,0.5294117647058824
y6QIX1rmFzo,67,199,28,294,0.22789115646258504,0.22789115646258504,0.6768707482993197
y8iQuyRRRSk,3,1,0,4,0.75,0.75,0.25
y90P7f1Mvf8,11,13,2,26,0.4230769230769231,0.4230769230769231,0.5
yAKSv0eDY7A,55,77,5,137,0.40145985401459855,0.40145985401459855,0.5620437956204379
yAdbjtXr1YY,7,11,1,19,0.3684210526315789,0.3684210526315789,0.5789473684210527
yAjV1nulCfY,10,11,0,21,0.47619047619047616,0.47619047619047616,0.5238095238095238
yB8Nnylhgn8,31,36,5,72,0.4305555555555556,0.4305555555555556,0.5
yCD-GSyL6Qo,41,33,4,78,0.5256410256410257,0.5256410256410257,0.4230769230769231
yDvt6jBM-6Y,2,12,2,16,0.125,0.125,0.75
yFVwfuKTuzY,31,25,5,61,0.5081967213114754,0.5081967213114754,0.4098360655737705
yGS3FonihsQ,17,30,3,50,0.34,0.34,0.6
yJYeuw_jA4E,7,14,2,23,0.30434782608695654,0.30434782608695654,0.6086956521739131
yJddvcT81gk,10,58,3,71,0.14084507042253522,0.14084507042253522,0.8169014084507042
yJpvHDfD3zY,21,32,2,55,0.38181818181818183,0.38181818181818183,0.5818181818181818
yJwPBfwKUKc,11,8,2,21,0.5238095238095238,0.5238095238095238,0.38095238095238093
yKCSqZvgQzg,2,14,2,18,0.1111111111111111,0.1111111111111111,0.7777777777777778
yMEOtdX3OLk,19,14,2,35,0.5428571428571428,0.5428571428571428,0.4
yMh458rKmbQ,15,31,2,48,0.3125,0.3125,0.6458333333333334
yN1CTCthxZs,5,9,1,15,0.3333333333333333,0.3333333333333333,0.6
yPcjNAcJs6w,125,329,51,505,0.24752475247524752,0.24752475247524752,0.6514851485148515
yPnHAXAQo-c,26,11,1,38,0.6842105263157895,0.6842105263157895,0.2894736842105263
yQ3N0rPT3zI,4,6,1,11,0.36363636363636365,0.36363636363636365,0.5454545454545454
yQNFsl2PElY,5,15,1,21,0.23809523809523808,0.23809523809523808,0.7142857142857143
yQZy1wV9yjc,6,66,4,76,0.07894736842105263,0.07894736842105263,0.868421052631579
yRmhoFkxQ0E,19,21,4,44,0.4318181818181818,0.4318181818181818,0.4772727272727273
ySIosD4lJow,3,2,2,7,0.42857142857142855,0.42857142857142855,0.2857142857142857
yTKm5SO7qkU,8,33,3,44,0.18181818181818182,0.18181818181818182,0.75
yTsgsElrlNE,13,21,8,42,0.30952380952380953,0.30952380952380953,0.5
yVFQnc9WIks,20,60,7,87,0.22988505747126436,0.22988505747126436,0.6896551724137931
yV_TH1Awif8,9,30,0,39,0.23076923076923078,0.23076923076923078,0.7692307692307693
yWCQ5GtRM9o,33,10,1,44,0.75,0.75,0.22727272727272727
yXXK0jNwIPE,11,33,5,49,0.22448979591836735,0.22448979591836735,0.673469387755102
ybDBDOH2r0c,6,32,1,39,0.15384615384615385,0.15384615384615385,0.8205128205128205
ybkCqVOGhms,22,34,4,60,0.36666666666666664,0.36666666666666664,0.5666666666666667
ycisXXg0Opc,8,15,2,25,0.32,0.32,0.6
ydF0MENSkCQ,3,19,1,23,0.13043478260869565,0.13043478260869565,0.8260869565217391
ydXUSBk4dts,9,39,6,54,0.16666666666666666,0.16666666666666666,0.7222222222222222
yed0EMHKk9g,27,72,3,102,0.2647058823529412,0.2647058823529412,0.7058823529411765
yfHiHPjD8Is,83,90,18,191,0.43455497382198954,0.43455497382198954,0.4712041884816754
ygFole5xSt8,6,39,2,47,0.1276595744680851,0.1276595744680851,0.8297872340425532
ygU40Exb08A,36,45,8,89,0.4044943820224719,0.4044943820224719,0.5056179775280899
yhTl8qa-xms,2,8,0,10,0.2,0.2,0.8
yiCw21WkkIA,44,25,5,74,0.5945945945945946,0.5945945945945946,0.33783783783783783
ykbE71KuR-E,14,53,2,69,0.2028985507246377,0.2028985507246377,0.7681159420289855
ykgggBYUBoQ,14,31,3,48,0.2916666666666667,0.2916666666666667,0.6458333333333334
ykjhb1_nbIQ,20,9,0,29,0.6896551724137931,0.6896551724137931,0.3103448275862069
yktKvtdq7L4,106,268,43,417,0.2541966426858513,0.2541966426858513,0.6426858513189448
yl_3bijNdSM,247,578,111,936,0.2638888888888889,0.2638888888888889,0.6175213675213675
ynAVZsy0WOk,33,22,1,56,0.5892857142857143,0.5892857142857143,0.39285714285714285
ynwdmf8ncLs,91,120,8,219,0.4155251141552511,0.4155251141552511,0.547945205479452
yoCctI22tmI,9,33,8,50,0.18,0.18,0.66
yobMstQvLfU,100,104,15,219,0.45662100456621,0.45662100456621,0.4748858447488584
yp78l8QuIxE,13,14,2,29,0.4482758620689655,0.4482758620689655,0.4827586206896552
yppQBBYhyUM,18,5,0,23,0.782608695652174,0.782608695652174,0.21739130434782608
ypv8hJoPFDA,3,14,4,21,0.14285714285714285,0.14285714285714285,0.6666666666666666
yq_4pGIY714,1,11,3,15,0.06666666666666667,0.06666666666666667,0.7333333333333333
ysFaX9IYCok,239,903,106,1248,0.19150641025641027,0.19150641025641027,0.7235576923076923
ytk78KGmfug,223,51,6,280,0.7964285714285714,0.7964285714285714,0.18214285714285713
yuv-aUfjuws,14,42,5,61,0.22950819672131148,0.22950819672131148,0.6885245901639344
yvnMoSD_CEo,14,5,2,21,0.6666666666666666,0.6666666666666666,0.23809523809523808
ywllqZMht7I,9,8,1,18,0.5,0.5,0.4444444444444444
yx7VYnR4qFA,13,19,5,37,0.35135135135135137,0.35135135135135137,0.5135135135135135
yy7n3XsnO5Q,7,3,1,11,0.6363636363636364,0.6363636363636364,0.2727272727272727
z-A1XJouRCY,7,10,1,18,0.3888888888888889,0.3888888888888889,0.5555555555555556
z-WHCY3sr38,11,6,0,17,0.6470588235294118,0.6470588235294118,0.35294117647058826
z-jpDcZHb4Y,343,50,10,403,0.8511166253101737,0.8511166253101737,0.12406947890818859
z2Iki98nzH4,23,31,2,56,0.4107142857142857,0.4107142857142857,0.5535714285714286
z2nkGHzmDNk,16,21,2,39,0.41025641025641024,0.41025641025641024,0.5384615384615384
z3BJaXmkSH4,2,9,3,14,0.14285714285714285,0.14285714285714285,0.6428571428571429
z51WGP96C2c,14,14,1,29,0.4827586206896552,0.4827586206896552,0.4827586206896552
z5D4KI7UeRk,12,17,1,30,0.4,0.4,0.5666666666666667
z6wfykyDlYg,3,4,2,9,0.3333333333333333,0.3333333333333333,0.4444444444444444
z7BTxpY0qNI,10,20,1,31,0.3225806451612903,0.3225806451612903,0.6451612903225806
zAZOIz41ZYc,1,6,1,8,0.125,0.125,0.75
zBqIJ7PW-I0,19,19,1,39,0.48717948717948717,0.48717948717948717,0.48717948717948717
zCB21n59KBs,11,23,3,37,0.2972972972972973,0.2972972972972973,0.6216216216216216
zCqYyoy-uB4,10,19,0,29,0.3448275862068966,0.3448275862068966,0.6551724137931034
zDOOtbL0qyk,13,8,0,21,0.6190476190476191,0.6190476190476191,0.38095238095238093
zD_pBnKFMvY,19,23,2,44,0.4318181818181818,0.4318181818181818,0.5227272727272727
zG-bq-NdzdA,3,6,1,10,0.3,0.3,0.6
zHdehMnkjr4,8,24,2,34,0.23529411764705882,0.23529411764705882,0.7058823529411765
zIXv7tVyTNw,1,1,0,2,0.5,0.5,0.5
zIvAD2l9esw,13,44,2,59,0.22033898305084745,0.22033898305084745,0.7457627118644068
zJABzofMEtk,1,4,0,5,0.2,0.2,0.8
zJS_4v2yR7E,15,15,2,32,0.46875,0.46875,0.46875
zJayZ5_N-Vw,17,16,2,35,0.4857142857142857,0.4857142857142857,0.45714285714285713
zJqJGzt852E,12,40,6,58,0.20689655172413793,0.20689655172413793,0.6896551724137931
zLYPwukp0Pk,27,17,6,50,0.54,0.54,0.34
zMJ1qJmOInw,7,14,3,24,0.2916666666666667,0.2916666666666667,0.5833333333333334
zMkeQMGaKBM,19,59,7,85,0.2235294117647059,0.2235294117647059,0.6941176470588235
zP-8NzfkEg8,2,6,0,8,0.25,0.25,0.75
zP110ruWrIo,69,98,11,178,0.38764044943820225,0.38764044943820225,0.550561797752809
zPg3PqtbCBw,3,13,3,19,0.15789473684210525,0.15789473684210525,0.6842105263157895
zRK5mLXWc34,25,38,2,65,0.38461538461538464,0.38461538461538464,0.5846153846153846
zReW1Qc8ylY,26,36,5,67,0.3880597014925373,0.3880597014925373,0.5373134328358209
zS53C-j6hvs,2,5,0,7,0.2857142857142857,0.2857142857142857,0.7142857142857143
zSYAYu_-aIc,5,10,1,16,0.3125,0.3125,0.625
zSieRYeyn88,52,66,3,121,0.4297520661157025,0.4297520661157025,0.5454545454545454
zSvjEz7WU7o,5,15,3,23,0.21739130434782608,0.21739130434782608,0.6521739130434783
zUw67OtHFQw,5,59,5,69,0.07246376811594203,0.07246376811594203,0.855072463768116
zVvCJIYLVOw,5,13,1,19,0.2631578947368421,0.2631578947368421,0.6842105263157895
zWDJshoD7-4,1,11,0,12,0.08333333333333333,0.08333333333333333,0.9166666666666666
zXDI8mz-FKg,49,33,9,91,0.5384615384615384,0.5384615384615384,0.3626373626373626
zYrEi-6jvbU,6,14,2,22,0.2727272727272727,0.2727272727272727,0.6363636363636364
zZapnHaOQWc,2,21,1,24,0.08333333333333333,0.08333333333333333,0.875
zakFMVKzDco,2,0,0,2,1,1,0
zbjKvtLg-kE,8,0,2,10,0.8,0.8,0
zcMZTcmd2E4,13,54,7,74,0.17567567567567569,0.17567567567567569,0.7297297297297297
zdHNfFRyHy0,36,71,3,110,0.32727272727272727,0.32727272727272727,0.6454545454545455
zfTpMr61T24,10,48,7,65,0.15384615384615385,0.15384615384615385,0.7384615384615385
zgkuo6BmCPI,2,3,1,6,0.3333333333333333,0.3333333333333333,0.5
ziBqU5xAWFo,67,52,3,122,0.5491803278688525,0.5491803278688525,0.4262295081967213
zin337iekeQ,7,22,5,34,0.20588235294117646,0.20588235294117646,0.6470588235294118
zjbYwzRPoBc,7,13,2,22,0.3181818181818182,0.3181818181818182,0.5909090909090909
zjn7l5hQnZw,20,77,3,100,0.2,0.2,0.77
zoIQ5Aufijw,4,7,2,13,0.3076923076923077,0.3076923076923077,0.5384615384615384
zoOzQNCmJrc,2,5,1,8,0.25,0.25,0.625
zoTuKFPphTI,15,77,2,94,0.1595744680851064,0.1595744680851064,0.8191489361702128
zpjp6SOL2u0,5,20,1,26,0.19230769230769232,0.19230769230769232,0.7692307692307693
zqxPlwdIm_Y,11,7,0,18,0.6111111111111112,0.6111111111111112,0.3888888888888889
zrCjOpvAL_Q,6,22,2,30,0.2,0.2,0.7333333333333333
zrGE3BDKSwo,9,12,1,22,0.4090909090909091,0.4090909090909091,0.5454545454545454
zrekinANt48,1,9,1,11,0.09090909090909091,0.09090909090909091,0.8181818181818182
zs25xdkSSwY,74,344,74,492,0.15040650406504066,0.15040650406504066,0.6991869918699187
zsEjlZ5bI6A,173,191,34,398,0.43467336683417085,0.43467336683417085,0.4798994974874372
ztFLdGl6myw,31,11,0,42,0.7380952380952381,0.7380952380952381,0.2619047619047619
zvk60gR0nX0,220,143,23,386,0.5699481865284974,0.5699481865284974,0.3704663212435233
zwrzOeYs5w8,8,16,0,24,0.3333333333333333,0.3333333333333333,0.6666666666666666
zx9icu-sKsI,7,17,3,27,0.25925925925925924,0.25925925925925924,0.6296296296296297
zxTUyH0a23I,12,14,1,27,0.4444444444444444,0.4444444444444444,0.5185185185185185
zzHSw2-Knws,52,15,2,69,0.7536231884057971,0.7536231884057971,0.21739130434782608
zzSyZZGC2G0,6,13,2,21,0.2857142857142857,0.2857142857142857,0.6190476190476191
